Word	Label
[unused66]	latin
[unused69]	latin
[unused95]	latin
[SEP]	latin
9	latin
?	latin
«	latin
·	latin
ؒ	arabic
ج	arabic
و	arabic
َ	arabic
ُ	arabic
ٿ	arabic
ۆ	arabic
۴	arabic
গ	ben_ass
ছ	ben_ass
ঠ	ben_ass
ਐ	punjabi
ਘ	punjabi
ਝ	punjabi
ਭ	punjabi
਼	punjabi
ਜ਼	punjabi
੩	punjabi
੫	punjabi
੮	punjabi
੯	punjabi
ઉ	gujarati
ઋ	gujarati
ઍ	gujarati
ઔ	gujarati
ચ	gujarati
ઢ	gujarati
ધ	gujarati
ફ	gujarati
ય	gujarati
સ	gujarati
હ	gujarati
ી	gujarati
ુ	gujarati
ૉ	gujarati
ો	gujarati
૤	gujarati
૩	gujarati
૯	gujarati
எ	tamil
வ	tamil
ஹ	tamil
ః	telugu
ఇ	telugu
ఐ	telugu
ఛ	telugu
ఢ	telugu
ష	telugu
ౌ	telugu
్	telugu
ಅ	kannada
ಋ	kannada
ಖ	kannada
ಚ	kannada
ಜ	kannada
ಷ	kannada
಼	kannada
ೀ	kannada
ೆ	kannada
ೊ	kannada
೧	kannada
೭	kannada
ഋ	malayalam
ഒ	malayalam
ഠ	malayalam
ഫ	malayalam
ﺳ	arabic
ﻧ	arabic
ﻫ	arabic
ﻭ	arabic
کی	arabic
અને	gujarati
করে	ben_ass
ਹਨ	punjabi
இந்த	tamil
హెక్టార్లు	telugu
ਸ਼੍ਰੇਣੀ	punjabi
can	latin
ਇਹ	punjabi
না	ben_ass
20	latin
આવે	gujarati
زمرو	arabic
ਕਿ	punjabi
உள்ள	tamil
वह	deva
ٿي	arabic
two	latin
पूर्व	deva
گیا	arabic
بن	arabic
ప్రైవేటు	telugu
જે	gujarati
only	latin
દેશના	gujarati
my	latin
طور	arabic
असे	deva
خان	arabic
لاءِ	arabic
ਦੀਆਂ	punjabi
ગામના	gujarati
આંગણવાડી	gujarati
being	latin
ਪਿੰਡ	punjabi
लोग	deva
ತಮ್ಮ	kannada
ਆਪਣੇ	punjabi
ఇతర	telugu
പി	malayalam
కోడ్	telugu
ਤੌਰ	punjabi
కంటే	telugu
ఫోన్	telugu
మూలాలు	telugu
રીતે	gujarati
సినిమా	telugu
ఆసుపత్రి	telugu
شامل	arabic
തന്നെ	malayalam
ఆఫీసు	telugu
యొక్క	telugu
ले	deva
کرتے	arabic
వాణిజ్య	telugu
just	latin
তা	ben_ass
ఉన్నారు	telugu
کسی	arabic
असून	deva
দলের	ben_ass
రోడ్లు	telugu
வரலாறு	tamil
ਦਿੱਤਾ	punjabi
உள்ளன	tamil
ईसा	deva
નથી	gujarati
করেছে	ben_ass
پاڪستان	arabic
ਉਸਨੇ	punjabi
long	latin
هي	arabic
ಮೊದಲ	kannada
లు	telugu
1997	latin
कमी	deva
ਕੰਮ	punjabi
బావులు	telugu
అందుతుంది	telugu
ਵਾਲੇ	punjabi
கட்டுரைகள்	tamil
एका	deva
സ്	malayalam
ایران	arabic
tak	latin
language	latin
భూ	telugu
অব	ben_ass
परिवार	deva
صدر	arabic
per	latin
कंपनी	deva
بھارتی	arabic
સૌરાષ્ટ્ર	gujarati
பட்டியல்	tamil
హెక్టార్లలో	telugu
അമേരിക്കൻ	malayalam
ప్రవహిస్తుంది	telugu
তখন	ben_ass
خود	arabic
ਹੋਈ	punjabi
কে	ben_ass
نظر	arabic
২০১১	ben_ass
విస్తరించి	telugu
లైన్	telugu
महत्वपूर्ण	deva
நான்	tamil
ప్రాథమికోన్నత	telugu
పౌర	telugu
మొదలైనవి	telugu
പല	malayalam
অসমৰ	ben_ass
జూనియర్	telugu
ఔషధ	telugu
যদি	ben_ass
జనాభాతో	telugu
సరఫరాల	telugu
అంగన్	telugu
ఇళ్లతో	telugu
See	latin
पर्ने	deva
ప్రత్యామ్నాయ	telugu
ਹੁੰਦੀ	punjabi
కొరియర్	telugu
മികച്ച	malayalam
ਪਹਿਲਾਂ	punjabi
దివ్యాంగుల	telugu
కంకర	telugu
విత్తిన	telugu
చేస్తున్నారు	telugu
ਜੀਵਨ	punjabi
రోజుకు	telugu
మండలం	telugu
बन	deva
హాలు	telugu
সৃষ্টি	ben_ass
થઈ	gujarati
பல்வேறு	tamil
General	latin
ریاست	arabic
పంటలు	telugu
West	latin
along	latin
पूरा	deva
అమలవుతోంది	telugu
ڪنهن	arabic
వస్తువులు	telugu
شمالی	arabic
వినియోగంలో	telugu
woru	latin
వ్యవసాయేతర	telugu
કરતા	gujarati
નામ	gujarati
بے	arabic
ದೊಡ್ಡ	kannada
આવ્યો	gujarati
जे	deva
ಇದೆ	kannada
علاقے	arabic
বর্তমান	ben_ass
மீது	tamil
नई	deva
1973	latin
شاعر	arabic
करके	deva
din	latin
ಇವರು	kannada
મોટા	gujarati
کرکٹ	arabic
राष्ट्र	deva
aaj	latin
ਬਾਰੇ	punjabi
Institute	latin
ਨਾ	punjabi
થી	gujarati
माहिती	deva
অথবা	ben_ass
ഇദ്ദേഹം	malayalam
గుండా	telugu
died	latin
காலத்தில்	tamil
जिल्लाका	deva
संस्कृति	deva
ابو	arabic
فوج	arabic
open	latin
જો	gujarati
ಹಲವು	kannada
صورت	arabic
शासन	deva
سبب	arabic
علاوہ	arabic
ఆమె	telugu
ਸਕੂਲ	punjabi
گڏ	arabic
دونوں	arabic
அறிவியல்	tamil
ಹೆಸರು	kannada
ਜਾਂਦੇ	punjabi
گن	arabic
मुख्यमंत्री	deva
જાય	gujarati
शोध	deva
ਲੇਖਕ	punjabi
دن	arabic
تعداد	arabic
पद	deva
अस्मिन्	deva
ಬಿ	kannada
യു	malayalam
पहिला	deva
राजकारणी	deva
જોવા	gujarati
لا	arabic
ക്ഷേത്രം	malayalam
possible	latin
ਉਸਨੂੰ	punjabi
లోనూ	telugu
మంచినీటి	telugu
ھو	arabic
இடம்	tamil
শ্রেষ্ঠ	ben_ass
ಬೇರೆ	kannada
चर्चा	deva
هر	arabic
২০১৭	ben_ass
रात	deva
ڏنو	arabic
1930	latin
lost	latin
month	latin
வருகிறது	tamil
production	latin
نگار	arabic
இருப்பினும்	tamil
सालमा	deva
ചലച്ചിത്രങ്ങൾ	malayalam
మంది	telugu
मानिसहरू	deva
companies	latin
room	latin
లింకులు	telugu
ਵਲੋਂ	punjabi
ਸਰਕਾਰ	punjabi
మండలంలోని	telugu
போர்	tamil
মুসলিম	ben_ass
صدي	arabic
ਕਰਨਾ	punjabi
air	latin
થયા	gujarati
രണ്ടാം	malayalam
കൂടി	malayalam
سيد	arabic
மே	tamil
કરતાં	gujarati
ਅੰਗਰੇਜ਼ੀ	punjabi
ਫ਼ਿਲਮ	punjabi
બની	gujarati
দ্বাৰা	ben_ass
اوہائیو	arabic
नेतृत्व	deva
நூல்கள்	tamil
looking	latin
Paul	latin
lang	latin
संशोधन	deva
संकेतस्थळ	deva
ಅದೇ	kannada
নয়	ben_ass
योग्य	deva
ರಿಂದ	kannada
کریں	arabic
भाजपा	deva
ग्राम	deva
स्वरूप	deva
బావుల	telugu
ಎಂಬುದು	kannada
ઉપર	gujarati
رهي	arabic
ભારતના	gujarati
ઘણી	gujarati
ਸਿੱਖਿਆ	punjabi
ਆਪ	punjabi
പറഞ്ഞു	malayalam
అయితే	telugu
तत्कालीन	deva
اتر	arabic
situation	latin
লৈ	ben_ass
জাতীয়	ben_ass
മൂന്ന്	malayalam
ਉਸਦੀ	punjabi
ರಾಜಕೀಯ	kannada
ప్రభుత్వం	telugu
२९	deva
బీడు	telugu
കി	malayalam
विधायक	deva
energy	latin
ਪਾਕਿਸਤਾਨ	punjabi
ever	latin
ನಡೆದ	kannada
হত	ben_ass
ഇത്തരം	malayalam
છતાં	gujarati
ਸਿੱਖ	punjabi
birth	latin
పోతోంది	telugu
বই	ben_ass
ترین	arabic
পাঁচ	ben_ass
ഏപ്രിൽ	malayalam
அறங்காவலர்	tamil
తమ	telugu
ദി	malayalam
ਪਾਣੀ	punjabi
চলচ্চিত্ৰ	ben_ass
आंबेडकर	deva
एतत्	deva
ٹیکساس	arabic
நகரம்	tamil
ضرورت	arabic
attack	latin
പോലെ	malayalam
ਕੀ	punjabi
whether	latin
அதற்கு	tamil
جسم	arabic
ਟੀਮ	punjabi
ಎಂ	kannada
সারা	ben_ass
നടത്തിയ	malayalam
ਅੰਦਰ	punjabi
natural	latin
ਵਿਚੋਂ	punjabi
நாடுகள்	tamil
ಇದೇ	kannada
సంవత్సరం	telugu
مثال	arabic
అది	telugu
شائع	arabic
1929	latin
প্রতিষ্ঠা	ben_ass
ਵੱਲੋਂ	punjabi
ਔਰਤਾਂ	punjabi
shows	latin
ప్రజలు	telugu
২০০৩	ben_ass
ఇవి	telugu
ಮತ್ತೆ	kannada
પાસે	gujarati
पात्र	deva
الاقوامی	arabic
ಯಾವ	kannada
joined	latin
سخت	arabic
teams	latin
ইয়াক	ben_ass
அடுத்த	tamil
காண்க	tamil
software	latin
மீட்டர்	tamil
చెరువులు	telugu
આપે	gujarati
continued	latin
موجودہ	arabic
दिखाई	deva
গ্রামের	ben_ass
જીવન	gujarati
کیرولائنا	arabic
వి	telugu
अली	deva
বের	ben_ass
कवी	deva
السلام	arabic
सर्वश्रेष्ठ	deva
چھ	arabic
૧૦	gujarati
جواب	arabic
ആദ്യം	malayalam
bring	latin
1925	latin
قبول	arabic
staff	latin
حال	arabic
সংস্কৃতি	ben_ass
കഥ	malayalam
પહેલા	gujarati
అన్ని	telugu
ਜਾਣਿਆ	punjabi
موقع	arabic
1923	latin
لکھا	arabic
दैनिक	deva
ਵੱਡੇ	punjabi
అంటే	telugu
सैन्य	deva
കാണപ്പെടുന്നു	malayalam
ਅੱਜ	punjabi
शुद्ध	deva
ਹੋਵੇ	punjabi
کونسل	arabic
पाच	deva
parents	latin
എന്നത്	malayalam
தஞ்சாவூர்	tamil
નવા	gujarati
Sir	latin
previous	latin
ਉੱਤਰ	punjabi
علاقوں	arabic
ವರ್ಷದ	kannada
سانچہ	arabic
ورجینیا	arabic
سواءِ	arabic
حد	arabic
ਖਿਡਾਰੀ	punjabi
കേന്ദ്ര	malayalam
simple	latin
writer	latin
ആൻഡ്	malayalam
رکي	arabic
విశాఖపట్నం	telugu
पैसे	deva
ਗੀਤ	punjabi
قدر	arabic
table	latin
इंडियन	deva
ਕ੍ਰਿਕਟ	punjabi
లభిస్తుంది	telugu
نوبل	arabic
किस	deva
मिनट	deva
চীন	ben_ass
ਸੇਵਾ	punjabi
رکيو	arabic
चलते	deva
پاران	arabic
حالات	arabic
characters	latin
खेती	deva
ಸೇರಿದಂತೆ	kannada
ਐਸ	punjabi
ਮੰਤਰੀ	punjabi
শাখা	ben_ass
growth	latin
ಇದರಿಂದ	kannada
గోదావరి	telugu
ಬೆಂಗಳೂರು	kannada
انسانی	arabic
जेल	deva
coach	latin
individual	latin
آبادي	arabic
மேற்பட்ட	tamil
shown	latin
ವಾಣಿಜ್ಯ	kannada
letter	latin
ഇതിനെ	malayalam
সৰু	ben_ass
हात	deva
bar	latin
రాజకీయ	telugu
परिवहन	deva
নিযুক্ত	ben_ass
பொறியியல்	tamil
नंबर	deva
શેરડી	gujarati
दावा	deva
अकरोत्	deva
ਦੱਖਣੀ	punjabi
खेलाडीहरू	deva
ਸ੍ਰੀ	punjabi
پہاڑ	arabic
اسکول	arabic
ਪੰਜ	punjabi
अङ्ग्रेजी	deva
چوندا	arabic
ਬਣਾਉਣ	punjabi
नेटवर्क	deva
टीवी	deva
ਉਸਦਾ	punjabi
જેવાં	gujarati
অবস্থা	ben_ass
काळ	deva
episode	latin
ഗ്രാമപഞ്ചായത്ത്	malayalam
بنانے	arabic
هنن	arabic
மூலமாக	tamil
सक्षम	deva
বল	ben_ass
નીચે	gujarati
बनने	deva
প্রযুক্তি	ben_ass
ফলত	ben_ass
മാത്രമാണ്	malayalam
লা	ben_ass
జిల్లాలో	telugu
فوجی	arabic
চারটি	ben_ass
مصنفین	arabic
सीमित	deva
عدالت	arabic
ਧਾਰਮਿਕ	punjabi
ഔദ്യോഗിക	malayalam
७८	deva
અસર	gujarati
तत्	deva
صوبے	arabic
fight	latin
ਅਧਿਐਨ	punjabi
ಕ್ರಿ	kannada
ਮਨੁੱਖ	punjabi
అదే	telugu
ਐਮ	punjabi
జరిగింది	telugu
೧೦	kannada
complex	latin
અંગે	gujarati
కాకుండా	telugu
महाभारत	deva
ನಡುವಿನ	kannada
ডেস্ক	ben_ass
పశ్చిమ	telugu
తండ్రి	telugu
குழந்தைகள்	tamil
চতুর্থ	ben_ass
રાજા	gujarati
இருப்பதால்	tamil
جائیں	arabic
சேவை	tamil
நிதி	tamil
ਕਿਲੋਮੀਟਰ	punjabi
എഴുതിയ	malayalam
ਲਗਭਗ	punjabi
വിദ്യാഭ്യാസ	malayalam
వచ్చింది	telugu
learning	latin
నటించిన	telugu
तेस्रो	deva
સ્થાનિક	gujarati
ਮਨੁੱਖੀ	punjabi
Another	latin
دوست	arabic
പറയുന്നത്	malayalam
వీరు	telugu
ഭാഗമായി	malayalam
ನೇ	kannada
ਅਧੀਨ	punjabi
ஏழு	tamil
Prehistoric	latin
તેવા	gujarati
ಪ್ರದೇಶದಲ್ಲಿ	kannada
ಹಾಗೆ	kannada
ਅਪ੍ਰੈਲ	punjabi
ಬಹುತೇಕ	kannada
Windows	latin
ਕਦੇ	punjabi
ترجمو	arabic
آمريڪا	arabic
पश्चात	deva
అవుతోంది	telugu
নীতি	ben_ass
ਛੋਟੇ	punjabi
পুরো	ben_ass
मग	deva
سکتی	arabic
మాత్రం	telugu
நூற்றாண்டின்	tamil
الگ	arabic
రైలు	telugu
jan	latin
ಹೇಗೆ	kannada
ಜನವರಿ	kannada
ਆਇਆ	punjabi
திருநெல்வேலி	tamil
demand	latin
kuda	latin
ನೀರಾವರಿ	kannada
સી	gujarati
ਪੱਧਰ	punjabi
આશરે	gujarati
বিশ্বকাপের	ben_ass
Britain	latin
ఎక్కువగా	telugu
ਫਿਲਮਾਂ	punjabi
થતો	gujarati
ਬਾਬਾ	punjabi
ഉണ്ടായിരുന്നു	malayalam
Louis	latin
ਭੌਤਿਕ	punjabi
نبی	arabic
किलोमिटर	deva
ਬਣਿਆ	punjabi
বীর	ben_ass
ویژن	arabic
ವೈದ್ಯಕೀಯ	kannada
भरपूर	deva
યુ	gujarati
கருத்து	tamil
আহমদ	ben_ass
अदालत	deva
کیلئے	arabic
sarkari	latin
कार्यकारी	deva
આંતરરાષ્ટ્રીય	gujarati
పలు	telugu
समारोह	deva
ਚੀਨ	punjabi
૧૪	gujarati
அதனை	tamil
தன்னுடைய	tamil
چھُہ	arabic
ਵਰਗ	punjabi
Services	latin
یافتہ	arabic
लाइन	deva
customers	latin
আছেন	ben_ass
ಪ್ರಮಾಣದಲ್ಲಿ	kannada
انتہائی	arabic
একটু	ben_ass
அமெரிக்காவில்	tamil
حل	arabic
تاريخي	arabic
પ્રદેશમાં	gujarati
eventually	latin
राज्यस्य	deva
பலர்	tamil
చిత్తూరు	telugu
ప్రాంతంలో	telugu
तेजी	deva
দেবী	ben_ass
ಸಂಪರ್ಕ	kannada
ڪجھ	arabic
ഒരേ	malayalam
પુરસ્કાર	gujarati
li	latin
rang	latin
ਨੈਸ਼ਨਲ	punjabi
Muhammad	latin
ತಾಯಿ	kannada
فراہم	arabic
foot	latin
مسائل	arabic
Latin	latin
join	latin
মুখ	ben_ass
equipment	latin
വിവരങ്ങൾ	malayalam
मार्फत	deva
muslim	latin
निवास	deva
fully	latin
भेट	deva
happened	latin
ਕਾਰਜ	punjabi
मन्त्री	deva
श्टब्स्	deva
യൂറോപ്യൻ	malayalam
মালিক	ben_ass
विश्वचषक	deva
Volume	latin
पश्चात्	deva
ਕੁੱਲ	punjabi
நடிகை	tamil
आपली	deva
ന്റെ	malayalam
સ્થળો	gujarati
હાલમાં	gujarati
আবুল	ben_ass
drama	latin
memory	latin
জুড়ে	ben_ass
சூன்	tamil
Members	latin
પૂરી	gujarati
انصاف	arabic
खाजगी	deva
जागा	deva
ఈయన	telugu
ਲੜਾਈ	punjabi
માનવામાં	gujarati
ചലച്ചിത്രം	malayalam
লিমিটেড	ben_ass
Space	latin
তুমি	ben_ass
कार्यों	deva
notes	latin
library	latin
ਪੁਸਤਕ	punjabi
वैद्यकीय	deva
ಬರೆದ	kannada
நாடுகளின்	tamil
তারিখ	ben_ass
فارسي	arabic
പ്രവർത്തനം	malayalam
রূপ	ben_ass
ترقي	arabic
ব্যবসা	ben_ass
ત્યારબાદ	gujarati
ఉండే	telugu
நன்கு	tamil
జూన్	telugu
પડી	gujarati
अमेरिकेच्या	deva
ਸਾਹਿਤਕ	punjabi
വനിതാ	malayalam
لاطینی	arabic
পেতে	ben_ass
രീതി	malayalam
பெற	tamil
சொந்த	tamil
લોકપ્રિય	gujarati
કરવાનો	gujarati
થતા	gujarati
ਬਾਕੀ	punjabi
ਏਸ਼ੀਆ	punjabi
દેશ	gujarati
vehicles	latin
birds	latin
انقلاب	arabic
સુધીમાં	gujarati
فلوریڈا	arabic
લોકોને	gujarati
മാത്രമല്ല	malayalam
निवेश	deva
साना	deva
கேரள	tamil
விளையாட்டுவீரர்	tamil
தனியார்	tamil
ਅੰਤ	punjabi
கிலோமீட்டர்	tamil
கடலூர்	tamil
માટેના	gujarati
தனிப்பட்ட	tamil
વર્ષે	gujarati
ਐਨ	punjabi
علاج	arabic
उपस्थिति	deva
পূর্ণ	ben_ass
نہایت	arabic
notice	latin
ਦੁਨੀਆਂ	punjabi
ਨਗਰ	punjabi
थाले	deva
ஆகஸ்ட்	tamil
दूरसञ्चार	deva
establishments	latin
میکسیکو	arabic
rich	latin
आकर्षण	deva
option	latin
keval	latin
എല്ലാം	malayalam
புதுக்கோட்டை	tamil
scientific	latin
குறைவான	tamil
वडील	deva
কমিশন	ben_ass
போதும்	tamil
ಸ್ವಾತಂತ್ರ್ಯ	kannada
ਬਣਾਈ	punjabi
ભારતની	gujarati
સતત	gujarati
உள்ளூர்	tamil
Francisco	latin
ವಿಧಾನ	kannada
പ്രവർത്തനങ്ങൾ	malayalam
உலகில்	tamil
strength	latin
journey	latin
अरुण	deva
ਆਰ	punjabi
ممکن	arabic
الحکومت	arabic
மையம்	tamil
বাধা	ben_ass
१९८७	deva
शिकायत	deva
ఉన్నత	telugu
انگلستان	arabic
പലപ്പോഴും	malayalam
ਰਿਕਾਰਡ	punjabi
ابی	arabic
ਸੰਬੰਧ	punjabi
سلسلے	arabic
गरेपछि	deva
गो	deva
جاءِ	arabic
વાર	gujarati
referred	latin
علائقن	arabic
بحیرہ	arabic
सकाळी	deva
हिमालय	deva
ڪونه	arabic
ਘਟਨਾ	punjabi
ਵਾਂਗ	punjabi
జనవరి	telugu
امير	arabic
ઐતિહાસિક	gujarati
آتے	arabic
কমে	ben_ass
ਲਾਹੌਰ	punjabi
ਧਿਆਨ	punjabi
పురస్కారం	telugu
ಹೆಸರನ್ನು	kannada
ஆகியவற்றின்	tamil
রাজনীতি	ben_ass
থাকলেও	ben_ass
shooting	latin
৪৫	ben_ass
ਵਾਪਸ	punjabi
Uttar	latin
মেয়ে	ben_ass
مسیحی	arabic
follows	latin
પાડે	gujarati
प्रकारचे	deva
તમે	gujarati
১৯৬৬	ben_ass
kaise	latin
గృహాలు	telugu
ಗಾಳಿ	kannada
مذهب	arabic
unknown	latin
ಬಂದಿದೆ	kannada
लक्ष	deva
sampark	latin
interesting	latin
ahead	latin
করলেও	ben_ass
سورج	arabic
ਸਰੋਤ	punjabi
sakal	latin
ਆਪਣੀਆਂ	punjabi
ਕੇਵਲ	punjabi
ڏسو	arabic
কাজী	ben_ass
જેટલી	gujarati
సాహిత్య	telugu
మరణాలు	telugu
شیر	arabic
پيءُ	arabic
কাঠামো	ben_ass
എന്നിവയും	malayalam
transfer	latin
எதிர்	tamil
ਵੰਡ	punjabi
ਫੀਲਡ	punjabi
విజయనగరం	telugu
સામેલ	gujarati
శక్తి	telugu
টুয়েন্টি২০	ben_ass
ਬਦਲ	punjabi
आर्य	deva
ശക്തമായ	malayalam
সামান্য	ben_ass
تن	arabic
१९७९	deva
கலைஞர்	tamil
ವರ್ಷದಲ್ಲಿ	kannada
പൊതു	malayalam
ವೇಳೆಗೆ	kannada
वाढ	deva
الاقوامي	arabic
ഭാഷയിൽ	malayalam
கொலை	tamil
சிவகங்கை	tamil
ఇదే	telugu
મોટું	gujarati
ਮੁਹੰਮਦ	punjabi
મહત્વની	gujarati
માતા	gujarati
മുഖ്യ	malayalam
ઉચ્ચ	gujarati
तैयारी	deva
খেলে	ben_ass
നാടക	malayalam
ತಮಿಳು	kannada
अभियांत्रिकी	deva
छोरी	deva
कृतः	deva
கிட்டத்தட்ட	tamil
Beach	latin
شہرت	arabic
নেমে	ben_ass
লিখা	ben_ass
দৈর্ঘ্য	ben_ass
رہتا	arabic
ಪಡೆದು	kannada
മി	malayalam
ఇండియా	telugu
புது	tamil
సింగ్	telugu
ਜਿੱਤ	punjabi
નોંધપાત્ર	gujarati
smaller	latin
ઉપયોગમાં	gujarati
वय	deva
لک	arabic
محنت	arabic
असले	deva
vishesh	latin
praia	latin
رہیں	arabic
నాటికి	telugu
என்பன	tamil
సభ్యులు	telugu
കൂടെ	malayalam
ਵਿਰੁੱਧ	punjabi
കോളേജിൽ	malayalam
मै	deva
குரு	tamil
സാംസ്കാരിക	malayalam
মধ্যেই	ben_ass
ನದಿ	kannada
ಕವಿ	kannada
ಕಿಮಿ	kannada
நடந்து	tamil
advice	latin
ಪ್ರಶಸ್ತಿಯನ್ನು	kannada
دنوں	arabic
सुझाव	deva
ಮಾಡಬಹುದು	kannada
সা	ben_ass
ترتيب	arabic
সম্ভাবনা	ben_ass
പക്ഷികൾ	malayalam
सलाह	deva
లేవు	telugu
విజయం	telugu
کولمبیا	arabic
தாக்குதல்	tamil
സെൻസസ്	malayalam
PC	latin
उच्चारण	deva
చేస్తారు	telugu
jisamen	latin
यु	deva
ਸਹਾਇਤਾ	punjabi
সম্পাদনা	ben_ass
കഴിഞ്ഞു	malayalam
విడుదల	telugu
தெரிவித்தார்	tamil
حلقے	arabic
ફરીથી	gujarati
ಹೇಳಿದರು	kannada
પુસ્તક	gujarati
इस्लामी	deva
electronic	latin
તરફથી	gujarati
देशमुख	deva
তেমন	ben_ass
قلم	arabic
ਕੁਦਰਤੀ	punjabi
মুসলমান	ben_ass
దర్శకత్వం	telugu
६५	deva
انهي	arabic
रोचक	deva
ਗਾਂਧੀ	punjabi
ന്ന്	malayalam
ಅಮೆರಿಕ	kannada
ক্ষুদ্র	ben_ass
flag	latin
ಟೆಸ್ಟ್	kannada
मुद्दे	deva
kill	latin
१०००	deva
اولهه	arabic
തായ്	malayalam
நிறுவப்பட்டது	tamil
روشن	arabic
Photo	latin
माध्यमातून	deva
আদালতে	ben_ass
امر	arabic
1872	latin
ಬಣ್ಣ	kannada
ಅಮೆರಿಕದ	kannada
mato	latin
آغا	arabic
జీవిత	telugu
समृद्ध	deva
रहना	deva
ਸਥਾਪਤ	punjabi
das	latin
ٻوليون	arabic
ઘર	gujarati
ಸಂಸ್ಕೃತ	kannada
شوق	arabic
ਪਿੰਡਾਂ	punjabi
വടക്കേ	malayalam
ആര്	malayalam
வட்டத்தில்	tamil
લઇ	gujarati
ਲਾਗੂ	punjabi
সেটি	ben_ass
భారతదేశం	telugu
ഇടയിൽ	malayalam
مہم	arabic
रॉयल	deva
મીટર	gujarati
നാമം	malayalam
ਪਾਤਰ	punjabi
ಜಾಗತಿಕ	kannada
કિમી	gujarati
হিন্দী	ben_ass
देतात	deva
കുറിപ്പുകൾ	malayalam
ৰূপে	ben_ass
शतकात	deva
സ്റ്റേറ്റ്	malayalam
साप्ताहिक	deva
உண்மையான	tamil
బ్రిటిష్	telugu
ਯਾਤਰਾ	punjabi
غور	arabic
wing	latin
ಎಷ್ಟು	kannada
நகரங்கள்	tamil
covers	latin
آپ	arabic
صادق	arabic
vibhinn	latin
duusari	latin
ਦਿਹਾਂਤ	punjabi
ಮರದ	kannada
स्वतन्त्रता	deva
தொலைவிலும்	tamil
ਜਦ	punjabi
কৃষ্ণ	ben_ass
123	latin
ಮಧ್ಯೆ	kannada
ವರ್ಲ್ಡ್	kannada
ਕੜੀਆਂ	punjabi
گردی	arabic
സാങ്കേതിക	malayalam
೦೦೦	kannada
कानूनी	deva
গাছের	ben_ass
قبائل	arabic
કોલેજ	gujarati
সমুদ্র	ben_ass
ನೀರನ್ನು	kannada
113	latin
കൂടിയാണ്	malayalam
દેશોમાં	gujarati
വേൾഡ്	malayalam
દાહોદ	gujarati
નવસારી	gujarati
ڄاڻايل	arabic
ਭਗਤ	punjabi
મુંબઈ	gujarati
प्रसन्न	deva
આસપાસ	gujarati
Stories	latin
જિલ્લા	gujarati
ਦਰਸ਼ਨ	punjabi
ಒಳ್ಳೆಯ	kannada
domain	latin
ਕਲਾਕਾਰ	punjabi
செய்யப்பட்டு	tamil
Assistant	latin
intelligence	latin
ಬಿಳಿ	kannada
نیچے	arabic
બાદમાં	gujarati
সংকলন	ben_ass
समकालीन	deva
പേരു	malayalam
காண	tamil
নবী	ben_ass
عیسوی	arabic
فوٽ	arabic
ਸੰਸਕ੍ਰਿਤ	punjabi
இதழ்கள்	tamil
३९	deva
ಇದರೊಂದಿಗೆ	kannada
Trade	latin
પેદા	gujarati
கடுமையான	tamil
ঘন	ben_ass
രാജ്യങ്ങളിൽ	malayalam
रेड	deva
ರನ್ನು	kannada
تجارت	arabic
થશે	gujarati
প্ৰতিষ্ঠান	ben_ass
സ്വാധീനം	malayalam
প্রতিরোধ	ben_ass
جناح	arabic
ಹಾಗಾಗಿ	kannada
ಉಂಟು	kannada
நகரின்	tamil
പെട്ട	malayalam
పూర్తిగా	telugu
لوک	arabic
പ്രത്യേകം	malayalam
स्व	deva
آيل	arabic
കേന്ദ്രം	malayalam
ਸਿਰ	punjabi
ਟਾਪੂ	punjabi
भेद	deva
لطيف	arabic
ಮಸೀದಿ	kannada
ഭൂമി	malayalam
તેનાથી	gujarati
కుమార్	telugu
இவன்	tamil
तरीका	deva
ಭಾಗದ	kannada
ਮਿੱਟੀ	punjabi
અંતરે	gujarati
ਸਮੁੰਦਰੀ	punjabi
نامور	arabic
ഭാഗമാണ്	malayalam
કદાચ	gujarati
நிகழ்ச்சி	tamil
కాక	telugu
Nov	latin
খেলতে	ben_ass
কাউন্সিল	ben_ass
തുടര്	malayalam
உருவாக்க	tamil
திரைப்படங்களில்	tamil
Yadav	latin
विना	deva
डि	deva
ਲਾ	punjabi
అప్పటి	telugu
કરનાર	gujarati
કરશે	gujarati
वस्तू	deva
ವಸ್ತುಗಳ	kannada
ਕਰਦਿਆਂ	punjabi
ഉള്ളത്	malayalam
تعليمي	arabic
AC	latin
கவனம்	tamil
ಒಳಗೆ	kannada
તેવું	gujarati
ਵਧ	punjabi
ముఖ్య	telugu
অবস্থানের	ben_ass
لیتے	arabic
ఖమ్మం	telugu
காட்டிலும்	tamil
ਮੇਰੇ	punjabi
ਸਹੀ	punjabi
যাওয়া	ben_ass
विंडोज	deva
ഇപ്പോഴത്തെ	malayalam
ಉತ್ಪಾದನೆ	kannada
ಈರುಳ್ಳಿ	kannada
ਯੋਗ	punjabi
سمجھ	arabic
তিনিটা	ben_ass
ফাইনালে	ben_ass
স্পষ্ট	ben_ass
ਜਿਸਦੇ	punjabi
வழங்கி	tamil
पुरस्कृत	deva
യും	malayalam
ਪਿਛਲੇ	punjabi
ডা	ben_ass
ലഭ്യമാണ്	malayalam
ಸೂಕ್ತ	kannada
പുറത്തേയ്ക്കുള്ള	malayalam
allowing	latin
மாரியம்மன்	tamil
Punjabi	latin
దానికి	telugu
ആരംഭിച്ചത്	malayalam
எளிய	tamil
મળ્યું	gujarati
डहाणू	deva
ಆಧಾರಿತ	kannada
நீரில்	tamil
তাঁরা	ben_ass
নদীৰ	ben_ass
ഇതിലെ	malayalam
সলনি	ben_ass
ஆகியன	tamil
രാവിലെ	malayalam
જંગલમાંથી	gujarati
novels	latin
streets	latin
అయినా	telugu
സാധിക്കും	malayalam
होनी	deva
انجمن	arabic
کون	arabic
ਪਾ	punjabi
تعارف	arabic
મધ્યપૂર્વ	gujarati
முழுமையாக	tamil
வான்	tamil
இந்தியக்	tamil
వాడు	telugu
arasu	latin
१९४६	deva
শ্রী	ben_ass
ஒப்பந்தம்	tamil
essay	latin
కొందరు	telugu
বন্দী	ben_ass
கிபி	tamil
ਨਵਾਂ	punjabi
119	latin
criminal	latin
বিধান	ben_ass
சைவ	tamil
கருப்பு	tamil
நடந்தது	tamil
दिसतात	deva
320	latin
Religion	latin
થવા	gujarati
توانائی	arabic
ਵਿਰੋਧ	punjabi
قبضو	arabic
வானொலி	tamil
அம்மா	tamil
സാമ്രാജ്യം	malayalam
ஒலிம்பிக்	tamil
ખોરાક	gujarati
1855	latin
સદી	gujarati
গোলে	ben_ass
వరంగల్	telugu
ആറു	malayalam
اعلی	arabic
সময়কালে	ben_ass
રાખી	gujarati
సమీపంలో	telugu
অধিকারী	ben_ass
సినీ	telugu
ਮਾਤਰਾ	punjabi
पाप	deva
gate	latin
स्तन	deva
ஓய்வு	tamil
આવશે	gujarati
ദേവി	malayalam
ਸੂਰਜ	punjabi
پہ	arabic
বিতর্ক	ben_ass
દે	gujarati
عوامي	arabic
ঢাকায়	ben_ass
అయింది	telugu
సంస్థలు	telugu
भविष्यति	deva
എന്	malayalam
மனிதன்	tamil
ലഭിച്ചിട്ടുണ്ട്	malayalam
عثمانیہ	arabic
ਮੰਗ	punjabi
বৃহত্তর	ben_ass
ਮਿਲਦੀ	punjabi
चौथी	deva
ਉਦਾਹਰਨ	punjabi
కాబట్టి	telugu
તળાવ	gujarati
পৰ্যন্ত	ben_ass
ಮಹತ್ವದ	kannada
చదివిన	telugu
ക്ഷേത്രത്തിലെ	malayalam
குறியீடு	tamil
ڏاڍو	arabic
రాజా	telugu
१९२०	deva
ਬਣਾਏ	punjabi
ઝડપી	gujarati
ਹਮਲਾ	punjabi
લઈને	gujarati
ஏற்றுக்	tamil
কমিশনের	ben_ass
എങ്ങനെ	malayalam
ؤزیٖر	arabic
ਵਿਆਖਿਆ	punjabi
சூழல்	tamil
ಪುರಾತನ	kannada
اختر	arabic
ಅಲ್	kannada
leads	latin
ഉയരമുള്ള	malayalam
അധികാരം	malayalam
ਸੁਰੱਖਿਆ	punjabi
ഗ്രാമം	malayalam
೧೭	kannada
ਇੰਡੀਅਨ	punjabi
ڀيرو	arabic
রং	ben_ass
childhood	latin
انٹرنیشنل	arabic
ਰਹਿੰਦੀ	punjabi
सेनाको	deva
বায়ু	ben_ass
உன்	tamil
રાખે	gujarati
خارجہ	arabic
बहवः	deva
இருப்பதாக	tamil
சேர்ந்தார்	tamil
૧૫	gujarati
Image	latin
দিয়েছে	ben_ass
হোটেল	ben_ass
ചുവന്ന	malayalam
साखर	deva
વસ્તુઓ	gujarati
हस्तक्षेप	deva
ബോർഡ്	malayalam
معاشی	arabic
পাবে	ben_ass
ھوندي	arabic
बचत	deva
ਬੰਗਾਲ	punjabi
পৌর	ben_ass
વ્યક્તિગત	gujarati
ਸਾਗਰ	punjabi
ਆਗੂ	punjabi
अन्यथा	deva
পাকিস্তানে	ben_ass
வீட்டு	tamil
હિન્દી	gujarati
தங்க	tamil
grown	latin
মাত্রা	ben_ass
دورہ	arabic
इसीलिए	deva
ਕਰੀਬ	punjabi
কোথাও	ben_ass
अनुपात	deva
ಗಂಡು	kannada
wasn	latin
સારવાર	gujarati
ಹೇಳಿದ್ದಾರೆ	kannada
வடிவமைப்பு	tamil
ਦਰਜ	punjabi
ਕਸ਼ਮੀਰ	punjabi
વિરુદ્ધ	gujarati
ಗಾಂಧಿ	kannada
என்பதும்	tamil
ಸಾಲ	kannada
ساڳئي	arabic
dena	latin
ਵਰਤੇ	punjabi
কারনে	ben_ass
एम्	deva
দেখার	ben_ass
વિચાર	gujarati
ಕಂಪನಿಗಳು	kannada
ভেতরে	ben_ass
لاهور	arabic
ਹਾਕੀ	punjabi
ಮ್ಯಾಕ್	kannada
படத்தை	tamil
जवळपास	deva
১৯৩৪	ben_ass
முதலிய	tamil
ਸਾਰੀ	punjabi
spoken	latin
ग्राहकों	deva
ಪ್ರಾದೇಶಿಕ	kannada
કંપનીઓ	gujarati
அப்படியே	tamil
भूभाग	deva
పాడేరులోనూ	telugu
sand	latin
નહિ	gujarati
વિશ્વના	gujarati
ಮೂಲಭೂತ	kannada
இஸ்லாமிய	tamil
అమరావతి	telugu
सबभन्दा	deva
صلي	arabic
Tennessee	latin
ഇതാണ്	malayalam
ਅਗਲੇ	punjabi
தரம்	tamil
यूनाइटेड	deva
தொழில்நுட்பம்	tamil
మహిళా	telugu
రాత్రి	telugu
معاشرے	arabic
கோட்பாடு	tamil
बिंदु	deva
149	latin
विसं	deva
રક્ષણ	gujarati
মানৱ	ben_ass
നി	malayalam
વ્યાપક	gujarati
જોઈ	gujarati
احادیث	arabic
Seven	latin
சுற்றுச்சூழல்	tamil
ఉంటారు	telugu
ਮਕੈਨਿਕਸ	punjabi
جام	arabic
புதிதாக	tamil
রাশিয়ার	ben_ass
ಸಾಮ್ರಾಜ್ಯದ	kannada
टीमों	deva
పాట	telugu
1847	latin
മുഗൾ	malayalam
સૌપ્રથમ	gujarati
મહીસાગર	gujarati
ਲੇਕਿਨ	punjabi
গেম	ben_ass
রোগের	ben_ass
માંડવી	gujarati
resulted	latin
180px	latin
છેઃ	gujarati
آرام	arabic
પાડી	gujarati
مساجد	arabic
ਅਰਬੀ	punjabi
ਗਣਿਤ	punjabi
నవంబరు	telugu
ಎಂದೇ	kannada
ਮੀਲ	punjabi
अन्	deva
১৯১৯	ben_ass
मुसलमानों	deva
millions	latin
இருந்தும்	tamil
கேட்டு	tamil
হাৰ	ben_ass
ઉજવણીઓ	gujarati
ਖ਼ਾਸ	punjabi
திறந்த	tamil
ஓட்டங்கள்	tamil
प्रदेशात	deva
চাওক	ben_ass
मिळून	deva
கல்	tamil
کیسے	arabic
বইটি	ben_ass
ಚಿತ್ರವು	kannada
শতক	ben_ass
উপরের	ben_ass
હૈ	gujarati
విధానం	telugu
ਲੱਗੇ	punjabi
അവസരം	malayalam
rally	latin
அறிஞர்	tamil
ಪವಿತ್ರ	kannada
Las	latin
గత	telugu
ਦਸ	punjabi
தண்டனை	tamil
৫৪	ben_ass
তালিকাভুক্ত	ben_ass
தரவு	tamil
কীভাবে	ben_ass
જોવાલાયક	gujarati
நிறுவனத்தில்	tamil
आकाराचे	deva
మహా	telugu
నారాయణ	telugu
കൂടുതല്	malayalam
অবস্থার	ben_ass
ਸੀਜ਼ਨ	punjabi
ਹਲਕਾ	punjabi
রাজনীতিতে	ben_ass
sample	latin
পেয়েছেন	ben_ass
कैद	deva
جاپانی	arabic
ಉರ್ದು	kannada
நிருவாகியால்	tamil
شروعاتي	arabic
ਜਿਹੜੇ	punjabi
જર્મન	gujarati
ಸಹಕಾರ	kannada
حالانکہ	arabic
മോഹൻ	malayalam
ಅಪ್	kannada
వ్యాసాల	telugu
মন্ত্রণালয়	ben_ass
تمہارے	arabic
സഹായത്തോടെ	malayalam
விழாவில்	tamil
ಹಾಲು	kannada
തിരികെ	malayalam
ತಮ್ಮನ್ನು	kannada
ga	latin
બદલ	gujarati
ಭಾಗಗಳಲ್ಲಿ	kannada
mayor	latin
സ്വാമി	malayalam
சிதம்பரம்	tamil
ಆಸ್ಟ್ರೇಲಿಯಾ	kannada
चरणमा	deva
ਰਾਜਸਥਾਨ	punjabi
এসময়	ben_ass
বুলিও	ben_ass
సంస్కృత	telugu
பக்கத்தில்	tamil
പത്ത്	malayalam
সময়ের	ben_ass
ਪੈ	punjabi
ਅਭਿਨੇਤਰੀ	punjabi
فعل	arabic
ರಾಣಿ	kannada
ಚುನಾವಣೆಯಲ್ಲಿ	kannada
দিনৰ	ben_ass
புற்றுநோய்	tamil
চায়	ben_ass
ਦਰਸਾਇਆ	punjabi
লক্ষণ	ben_ass
ગૌણ	gujarati
সংকেত	ben_ass
apart	latin
அணியில்	tamil
ਪ੍ਰੇਮ	punjabi
rakhen	latin
অবস্থানে	ben_ass
Travel	latin
तैनात	deva
ઉદ્યોગ	gujarati
પરિવહન	gujarati
button	latin
પાત્ર	gujarati
گاڑی	arabic
இப்	tamil
જી	gujarati
ఏరియా	telugu
ਜਹਾਜ਼	punjabi
update	latin
ডিব্ৰুগড়	ben_ass
സംബന്ധിച്ച്	malayalam
প্ৰাণী	ben_ass
ਨੀ	punjabi
ਜਾਣੀ	punjabi
बेलायती	deva
कैमरा	deva
পাবেন	ben_ass
ಮಕ್ಕಳಿಗೆ	kannada
ਪੱਤਰਕਾਰ	punjabi
সংসদীয়	ben_ass
ಮಾಡಬೇಕು	kannada
সুর	ben_ass
போட்டியிட்டு	tamil
ledu	latin
ಅಂದಿನ	kannada
एकीकरण	deva
قبضي	arabic
નિષ્ફળ	gujarati
నగరంలో	telugu
Hai	latin
கொண்டுள்ள	tamil
ਬਾਦ	punjabi
೧೪	kannada
ವೇರ್	kannada
લોકોના	gujarati
ఇచ్చారు	telugu
شعور	arabic
પછીના	gujarati
بنگالی	arabic
இயலும்	tamil
ਦੋਸ਼	punjabi
കാലാവസ്ഥ	malayalam
bench	latin
ਸਾਨੂੰ	punjabi
पहिलोपटक	deva
লোকজন	ben_ass
Prix	latin
പ്രതിഷ്ഠ	malayalam
शारदा	deva
ਬਿਆਨ	punjabi
گڏوگڏ	arabic
abuse	latin
റിപ്പോര്	malayalam
ਦਿਸ਼ਾ	punjabi
ਵਾਧਾ	punjabi
ઉત્પન્ન	gujarati
খেতে	ben_ass
প্ৰয়োজন	ben_ass
ഇതോടെ	malayalam
اچھا	arabic
പൂര്	malayalam
ನೀಡಿದೆ	kannada
பாரதிய	tamil
மாநிலத்திலுள்ள	tamil
વનપેદાશો	gujarati
ਨੌਕਰੀ	punjabi
ڳنڍڻا	arabic
ਸਮੱਗਰੀ	punjabi
ఉందని	telugu
پرائمري	arabic
ચાલી	gujarati
183	latin
ওর	ben_ass
ਆਕਾਰ	punjabi
कारणेन	deva
నన్ను	telugu
ਅਖੀਰ	punjabi
পৰীক্ষাত	ben_ass
విషయంలో	telugu
اکر	arabic
কিঃমিঃ	ben_ass
એકમાત્ર	gujarati
தூய	tamil
جنهنڪري	arabic
پیمانے	arabic
మళ్ళీ	telugu
പ്രദേശമാണ്	malayalam
பாடிய	tamil
কেমন	ben_ass
ਰੱਖੀ	punjabi
దర్శకత్వంలో	telugu
प्रदीप	deva
samarthan	latin
आदित्य	deva
ਪੰਨਾ	punjabi
ಕೂಡಿದ	kannada
ਐਸੋਸੀਏਸ਼ਨ	punjabi
જતાં	gujarati
നിയമ	malayalam
فضا	arabic
cable	latin
પૌરાણિક	gujarati
ਰਾਗ	punjabi
راڄ	arabic
যেকোন	ben_ass
ਰਾਜਾਂ	punjabi
ভিটামিন	ben_ass
बैठ	deva
ब्रांड	deva
கொடுக்கும்	tamil
শতাধিক	ben_ass
প্ৰজাতি	ben_ass
সিলেটের	ben_ass
ജോസ്	malayalam
ಮಂಗಳೂರು	kannada
દબાણ	gujarati
இந்துக்	tamil
అమృత్	telugu
શહેરી	gujarati
Boys	latin
basari	latin
విశాఖపట్నంలోను	telugu
యునైటెడ్	telugu
മാറ്റങ്ങൾ	malayalam
اشارہ	arabic
ਹੱਲ	punjabi
దాడి	telugu
স্টেশনের	ben_ass
જીતી	gujarati
قليچ	arabic
england	latin
സഹോദരൻ	malayalam
ਧਾਰਾ	punjabi
പ്രവർത്തകർ	malayalam
ಭಾರಿ	kannada
उतना	deva
ਸਿਟੀ	punjabi
పుస్తకం	telugu
ધરાવતો	gujarati
سگھجي	arabic
ਡਾਲਰ	punjabi
અંગત	gujarati
നിങ്ങളുടെ	malayalam
আমেৰিকাৰ	ben_ass
కన్నడ	telugu
நாட்டை	tamil
अड्डा	deva
அங்கிருந்து	tamil
2009ء	arabic
പുറത്തു	malayalam
என்பதற்கு	tamil
કિનારે	gujarati
পঞ্চায়েত	ben_ass
ਵਿਸ਼ਲੇਸ਼ਣ	punjabi
কমলা	ben_ass
પુસ્તકો	gujarati
پاکِستانی	arabic
સામનો	gujarati
gari	latin
ராஜ்	tamil
జాతి	telugu
آتش	arabic
उपलब्धि	deva
ശിക്ഷ	malayalam
ਪੁਰਾਣਾ	punjabi
ਚੋਂ	punjabi
Guardian	latin
বিগত	ben_ass
واپسی	arabic
ڈیرہ	arabic
203	latin
एटीएम	deva
ਸੱਚ	punjabi
کائڻ	arabic
જાળવી	gujarati
یہود	arabic
ઔદ્યોગિક	gujarati
কৃত্রিম	ben_ass
صلح	arabic
লগা	ben_ass
असणे	deva
बिजनेस	deva
موجودگی	arabic
ஒன்றியத்தின்	tamil
Writers	latin
పనిచేశాడు	telugu
ਦੇਖਿਆ	punjabi
ਕੋਰਟ	punjabi
ഔഷധസസ്യങ്ങൾ	malayalam
നാരായണൻ	malayalam
નુકસાન	gujarati
युवराज	deva
थ्री	deva
ಲಾ	kannada
জিলাত	ben_ass
ಸೇವೆಯನ್ನು	kannada
സിവിൽ	malayalam
పరిధిలోకి	telugu
পৰিচয়	ben_ass
बेल	deva
ڪهاڻي	arabic
வாய்ப்பாடு	tamil
சோழன்	tamil
வேறுபட்ட	tamil
ಆಗುತ್ತದೆ	kannada
कोही	deva
ਸਮਰੱਥਾ	punjabi
આના	gujarati
ಎಂಬುದರ	kannada
నీరుగ్రామంలో	telugu
সংগ্রাম	ben_ass
దేశాలలో	telugu
طريقو	arabic
৫৭	ben_ass
فخر	arabic
چونڊن	arabic
કાળા	gujarati
امان	arabic
ഉപകരണങ്ങൾ	malayalam
कदाचित्	deva
ಸಮುದ್ರದ	kannada
સાબિત	gujarati
கருதப்படும்	tamil
खरेदी	deva
ਬਜਾਏ	punjabi
سرور	arabic
استنبول	arabic
సముద్ర	telugu
ಯೋಜನೆಯ	kannada
பெரியார்	tamil
આણંદ	gujarati
ಪರಿಚಯ	kannada
தாங்கள்	tamil
क्रान्तिकारी	deva
পড়া	ben_ass
കാലിഫോർണിയ	malayalam
ಸುತ್ತಲೂ	kannada
കഥാപാത്രങ്ങൾ	malayalam
ಡೇ	kannada
ಪ್ರಮಾಣವನ್ನು	kannada
திரைப்படத்	tamil
waves	latin
گذريو	arabic
رکيل	arabic
2008માં	gujarati
અભિનય	gujarati
बनकर	deva
rashtra	latin
నటులు	telugu
সম্প্রচার	ben_ass
pregnancy	latin
ਲੱਛਣ	punjabi
நகரங்களில்	tamil
collections	latin
ٽالپر	arabic
భాషలో	telugu
தூரம்	tamil
કોઈપણ	gujarati
printing	latin
பார்த்த	tamil
ಸ್ಥಾಪಿಸಿದರು	kannada
اداکاری	arabic
ದಸರಾ	kannada
यूनानी	deva
കഴിഞ്ഞാൽ	malayalam
লীগে	ben_ass
ప్రసిద్ధ	telugu
Welfare	latin
installation	latin
యుద్ధంలో	telugu
ಪರಿಸ್ಥಿತಿ	kannada
ಪುಟ್ಟ	kannada
يورپي	arabic
ವಿದ್ಯಾರ್ಥಿ	kannada
hosts	latin
Add	latin
ಆಚರಿಸುತ್ತಾರೆ	kannada
component	latin
ਰੂਪਾਂ	punjabi
कालेज	deva
rapidly	latin
ملتے	arabic
అనకాపల్లిలోను	telugu
द्वीपसमूह	deva
எளிதாக	tamil
పరిశోధన	telugu
ووڈ	arabic
১৯১০	ben_ass
സ്ഥാപിച്ചത്	malayalam
చాల	telugu
ਟੂਰਨਾਮੈਂਟ	punjabi
தகவல்களை	tamil
சமயங்களில்	tamil
ਨਾਥ	punjabi
શક્યતા	gujarati
યોર્ક	gujarati
ಹೇಳಲಾಗುತ್ತದೆ	kannada
ਸੰਵਿਧਾਨ	punjabi
జె	telugu
പത്തു	malayalam
ಪ್ರಧಾನಿ	kannada
angle	latin
वाणिज्यिक	deva
સાગનાં	gujarati
दाल	deva
தலைவன்	tamil
കപൂർത്തല	malayalam
ટેસ્ટ	gujarati
ತನ್ನನ್ನು	kannada
هميشه	arabic
કમ્પ્યુટર	gujarati
ਮਿਲਣ	punjabi
અનુવાદ	gujarati
હત્યા	gujarati
வடிவ	tamil
ਸਭਿਆਚਾਰਕ	punjabi
೨೦೦೮	kannada
காட்டி	tamil
इत्यत्र	deva
കവിതകൾ	malayalam
ಮಾರುಕಟ್ಟೆಯಲ್ಲಿ	kannada
ਦੂਸਰੇ	punjabi
ਐਫ	punjabi
Stage	latin
१९१०	deva
વૃક્ષ	gujarati
ತಪ್ಪು	kannada
ਵਾਤਾਵਰਣ	punjabi
Newspaper	latin
ਲਾਤੀਨੀ	punjabi
সংলাপ	ben_ass
पोषक	deva
பாடகர்	tamil
കളി	malayalam
एभिएन	deva
அரசர்கள்	tamil
ਸਵੀਕਾਰ	punjabi
તમને	gujarati
రాజ్యం	telugu
हुनुपर्छ	deva
beneficial	latin
beti	latin
Stock	latin
লর্ড	ben_ass
मन्दिरं	deva
बढ़ते	deva
సంబంధం	telugu
imran	latin
لاش	arabic
حاکم	arabic
റിസർച്ച്	malayalam
آپریشن	arabic
commissioned	latin
تحقیقات	arabic
நிறுவப்பட்ட	tamil
ਜਾਣੇ	punjabi
کمزور	arabic
पांडे	deva
सेमी	deva
ਜੇਲ੍ਹ	punjabi
ਰੋਲ	punjabi
قریبی	arabic
परमात्मा	deva
ক্ষতিগ্রস্ত	ben_ass
మీటర్ల	telugu
khush	latin
ਦਰਦ	punjabi
ભાર	gujarati
त्यसैगरी	deva
ಸರಣಿಯ	kannada
ਸੂਫ਼ੀ	punjabi
ਵਿਸ਼ੇਸ਼ਤਾਵਾਂ	punjabi
अमरीकी	deva
వ్యక్తిగత	telugu
ವಯಸ್ಸಿನ	kannada
august	latin
લીધા	gujarati
चरम	deva
ಬೇಡಿಕೆ	kannada
సెప్టెంబర్	telugu
શેર	gujarati
agle	latin
ചികിത്സ	malayalam
திரைக்கதை	tamil
જેતપુર	gujarati
நூல்களில்	tamil
saint	latin
வென்றது	tamil
প্ৰমাণ	ben_ass
একাডেমিক	ben_ass
মিশ্র	ben_ass
टक्कर	deva
ਜਾਪਾਨ	punjabi
महिमा	deva
واهه	arabic
কপি	ben_ass
ઘણો	gujarati
ಬಾಹ್ಯಾಕಾಶ	kannada
ট্রফি	ben_ass
ਜਵਾਬ	punjabi
நடு	tamil
அரசுக்கு	tamil
উল	ben_ass
جدوجہد	arabic
मौसमी	deva
మహిళలు	telugu
colony	latin
பருவ	tamil
કિંમત	gujarati
দূতাবাস	ben_ass
ಜತೆ	kannada
હવાઇમથક	gujarati
Begum	latin
কার্যালয়	ben_ass
ডেকা	ben_ass
dvitiya	latin
ملڪي	arabic
ਵਾਰਤਕ	punjabi
ਟਾਈਮ	punjabi
آهستي	arabic
ઓછો	gujarati
బయటకు	telugu
ತೀರ	kannada
ਕਤਲ	punjabi
दिलेली	deva
ഒക്കെ	malayalam
ಕಾರ	kannada
ஐந்தாம்	tamil
కలసి	telugu
ਰਿਪੋਰਟ	punjabi
चिया	deva
ਸਮਝਿਆ	punjabi
ఎలాంటి	telugu
அக்காலத்தில்	tamil
দেখায়	ben_ass
ગૂગલ	gujarati
પ્રતિબંધ	gujarati
ഉത്സവം	malayalam
স্টক	ben_ass
downlod	latin
HSL	latin
போராட்ட	tamil
ભોજન	gujarati
কংগ্ৰেছ	ben_ass
નવું	gujarati
கிளை	tamil
யூத	tamil
251	latin
వై	telugu
adhikariyon	latin
সেখানেই	ben_ass
Studios	latin
ലക്ഷ്മി	malayalam
deputy	latin
پوائنٹ	arabic
ದಾಖಲಾಗಿದೆ	kannada
بہاولپور	arabic
ഡയറക്ടർ	malayalam
राक्षस	deva
మొదలు	telugu
પાર	gujarati
Does	latin
દીધું	gujarati
স্ব	ben_ass
merged	latin
chattagram	latin
মুসলিমদের	ben_ass
ALIGN	latin
೨೦೦೭	kannada
లకు	telugu
രു	malayalam
असमर्थ	deva
ఆగష్టు	telugu
பட	tamil
വിദ്യാര്	malayalam
जन्मदिन	deva
ਖੇਡਣ	punjabi
خواہ	arabic
آور	arabic
AA	latin
Contact	latin
সমাজৰ	ben_ass
اسين	arabic
వచ్చారు	telugu
1930s	latin
مَزہَب	arabic
ತನಗೆ	kannada
फडके	deva
bistarit	latin
अद्वितीय	deva
અંતર	gujarati
ભિલોડા	gujarati
தவிர்த்து	tamil
कांस्य	deva
ஆங்கிலத்	tamil
மூலக்கூறு	tamil
commune	latin
आशंका	deva
سائنسي	arabic
মুখের	ben_ass
ನೀನು	kannada
operates	latin
కొండ	telugu
సాధించింది	telugu
موقف	arabic
প্রশান্ত	ben_ass
Learn	latin
ایسوسی	arabic
മധു	malayalam
തുക	malayalam
குண்டு	tamil
Am	latin
karyaalay	latin
ਅੱਖਾਂ	punjabi
ಖ್ಯಾತ	kannada
গৌতম	ben_ass
فيض	arabic
ഗ്രേറ്റ്	malayalam
வாழ்க்கைக்	tamil
ભાગની	gujarati
ಸ್ಥಳಗಳು	kannada
bhartee	latin
સામ્રાજ્ય	gujarati
নিয়েছেন	ben_ass
পত্র	ben_ass
احکام	arabic
என்பதன்	tamil
ಅಂಚೆ	kannada
રૂપ	gujarati
சமையல்	tamil
1822	latin
பெண்களும்	tamil
गोलाकार	deva
ఇంట్లో	telugu
बताई	deva
అడుగుల	telugu
ਕਣਾਂ	punjabi
પૂરો	gujarati
محترم	arabic
ఇతను	telugu
Access	latin
ஆண்டுக்கு	tamil
বাছাই	ben_ass
ಫಲವಾಗಿ	kannada
ਕੁ	punjabi
बसोवास	deva
വയനാട്	malayalam
వహించిన	telugu
ભાષાના	gujarati
മനോഹരമായ	malayalam
نوح	arabic
237	latin
ઉત્પાદનોના	gujarati
લાગ્યા	gujarati
ਦੋਸਤ	punjabi
ਦਰਬਾਰ	punjabi
து	tamil
അതോടെ	malayalam
लाग्यो	deva
significance	latin
மீற்றர்	tamil
இணைப்புக்கள்	tamil
ഊർജ്ജം	malayalam
ಬೆಂಗಳೂರಿನಲ್ಲಿ	kannada
கட்டுப்பாடு	tamil
కొత్తగా	telugu
વાતાવરણ	gujarati
ലാൽ	malayalam
സംസ്ഥാനത്ത്	malayalam
બાર	gujarati
مس	arabic
ਮੱਛੀ	punjabi
புகார்	tamil
చెందింది	telugu
নামানুসারে	ben_ass
পরিচালনায়	ben_ass
सांस	deva
સ્કૂલ	gujarati
च्यानल	deva
اولمپکس	arabic
northeast	latin
videsh	latin
কার্বন	ben_ass
ಯುಗಾದಿ	kannada
ہوگیا	arabic
কমিউনিটি	ben_ass
Congo	latin
ਸਰ	punjabi
پاسو	arabic
નેતૃત્વ	gujarati
ਯੂਨੀਵਰਸਿਟੀਆਂ	punjabi
Mathematical	latin
قریشی	arabic
আর্জেন্টিনা	ben_ass
മാതാപിതാക്കൾ	malayalam
دباؤ	arabic
معیاری	arabic
இரவில்	tamil
જઈ	gujarati
হোৱাত	ben_ass
karvama	latin
مٿس	arabic
धक्का	deva
بقول	arabic
వేసవి	telugu
டை	tamil
یسوع	arabic
ਗੀਤਕਾਰ	punjabi
ਵੱਖਰਾ	punjabi
ਆਰਟਸ	punjabi
ਚੈਨਲ	punjabi
ஆண்களுக்கு	tamil
ਆਯੋਜਿਤ	punjabi
ഇന്നു	malayalam
বিজেপি	ben_ass
సుబ్బారావు	telugu
விஷ்ணு	tamil
ಪಂದ್ಯದ	kannada
दुईवटा	deva
ఎన్నికల్లో	telugu
علمائے	arabic
தயாரிப்பில்	tamil
Samsung	latin
পূৰ্বে	ben_ass
মতবাদ	ben_ass
সিনেমার	ben_ass
ਮਹਾਰਾਸ਼ਟਰ	punjabi
काळा	deva
ملازم	arabic
అలాంటి	telugu
செய்தால்	tamil
మౌలిక	telugu
পৰিছিল	ben_ass
শিল্পকলা	ben_ass
اوبلاست	arabic
ચાઇનીઝ	gujarati
ਕੁਦਰਤ	punjabi
وین	arabic
സമ്മേളനം	malayalam
இருக்காது	tamil
विकत	deva
വിജയിച്ചു	malayalam
இலவச	tamil
ഗവർണർ	malayalam
નજીકના	gujarati
boats	latin
கண்டி	tamil
તેવો	gujarati
ڪانه	arabic
کاڌي	arabic
गोविन्द	deva
मिळालेले	deva
tears	latin
ਬੋਲ	punjabi
கார்த்திகை	tamil
টাউন	ben_ass
১লা	ben_ass
கிழக்குப்	tamil
నిర్వహణ	telugu
ಯೂನಿವರ್ಸಿಟಿ	kannada
ஸ்டார்	tamil
ಕಲೆಯ	kannada
રૂપમાં	gujarati
নমুনা	ben_ass
ਰਿਆਸਤ	punjabi
தொடங்கும்	tamil
அமைக்கப்பட்ட	tamil
ബംഗ്ലാദേശ്	malayalam
blind	latin
prashikshan	latin
മലയാളി	malayalam
ਰਸਮੀ	punjabi
Artists	latin
ದಕ್ಷಿಣದ	kannada
స్వయంగా	telugu
आजको	deva
ఉద్యోగం	telugu
గురువు	telugu
लागवड	deva
1793	latin
ঘটনাটি	ben_ass
ಪ್ರೌಢ	kannada
ലോകകപ്പ്	malayalam
FDA	latin
செயல்பாடுகள்	tamil
कृती	deva
ಪುಸ್ತಕಗಳನ್ನು	kannada
సహాయం	telugu
ఉదాహరణకు	telugu
மொபைல்	tamil
Stuart	latin
జీవితంలో	telugu
క్రింది	telugu
సంకలనం	telugu
ചിത്രീകരണം	malayalam
തീരത്ത്	malayalam
ನಗರಗಳು	kannada
പ്രശ്നം	malayalam
ಸಹಜ	kannada
૫૦	gujarati
ਖਾਣਾ	punjabi
mudiyadhu	latin
સૂચવે	gujarati
দশকত	ben_ass
পর্যায়	ben_ass
ಬಾಲ್ಯ	kannada
प्रहरीले	deva
प्रदेशे	deva
ವರ್ಷಗಳು	kannada
ਜਿਲ੍ਹੇ	punjabi
வருமானம்	tamil
ಕೇಂದ್ರದ	kannada
விசை	tamil
عورتون	arabic
ശൈലി	malayalam
আহিছিল	ben_ass
సం	telugu
Cuba	latin
పోలీస్	telugu
ಲೇಖನಗಳು	kannada
સાધન	gujarati
ವ್ಯತ್ಯಾಸ	kannada
sciences	latin
മറിച്ച്	malayalam
ਹੋਵੇਗੀ	punjabi
দৈৰ্ঘ্য	ben_ass
ਸਧਾਰਨ	punjabi
নিরপেক্ষ	ben_ass
ಹೆಸರುವಾಸಿ	kannada
பிற்பகுதியில்	tamil
గాను	telugu
ध्येय	deva
1802	latin
ਤਾਮਿਲ	punjabi
మించి	telugu
ಬಿಗ್	kannada
ಸಮಿತಿಯ	kannada
વેસ્ટ	gujarati
खैरो	deva
ജയിൽ	malayalam
నేడు	telugu
লাইভ	ben_ass
2000s	latin
CNN	latin
ગ્રામ	gujarati
ವಚನ	kannada
૧૭	gujarati
उत्सवाः	deva
అరకులోయలోను	telugu
وف	arabic
বেঁধে	ben_ass
ஐயர்	tamil
રોક	gujarati
अन्ना	deva
हार्दिक	deva
রাস্তাটি	ben_ass
অসীম	ben_ass
விளையாட்டுக்கள்	tamil
মঞ্চে	ben_ass
তেজপুৰ	ben_ass
तरिकाले	deva
વિસ્તૃત	gujarati
০৫	ben_ass
احسن	arabic
2007ರ	kannada
పూజలు	telugu
sid	latin
ഗുരുവായൂർ	malayalam
പുത്രൻ	malayalam
পূর্বেই	ben_ass
اقتصادي	arabic
থাকত	ben_ass
تالیف	arabic
સંપૂર્ણપણે	gujarati
ਵਿਸ਼ੇਸ਼ਤਾ	punjabi
ভাইরাস	ben_ass
સંરક્ષણ	gujarati
പുസ്തകത്തിൽ	malayalam
કુમાર	gujarati
சக	tamil
കിഴക്കേ	malayalam
നിങ്ങള്	malayalam
వైద్యుడు	telugu
బ్లాక్	telugu
بيماري	arabic
செய்கின்றன	tamil
મુશ્કેલ	gujarati
തെലുങ്ക്	malayalam
पल्ट	deva
કરાયેલા	gujarati
అందువలన	telugu
نڪتو	arabic
निकटतम	deva
ఆధ్యాత్మిక	telugu
ഹോം	malayalam
cattle	latin
Lion	latin
വൈറസ്	malayalam
उतर	deva
ਘਰਾਂ	punjabi
ವಿಷಯದ	kannada
اخلاقی	arabic
அறக்கட்டளை	tamil
ત્રીજી	gujarati
مارجي	arabic
ਸੀਰੀਜ਼	punjabi
गच्छन्ति	deva
जाम	deva
देहली	deva
આફ્રિકા	gujarati
wise	latin
পরমাণু	ben_ass
मिळवला	deva
Trinity	latin
Bhopal	latin
எடுக்கும்	tamil
করায়	ben_ass
Indonesian	latin
ਸਮਝਣ	punjabi
தோன்றுகிறது	tamil
آذربائيجان	arabic
सुरुमा	deva
2005માં	gujarati
کائي	arabic
smoke	latin
307	latin
ಮಾಸ್ಟರ್	kannada
શિકાર	gujarati
Teachers	latin
রায়ের	ben_ass
காலப்பகுதியில்	tamil
எங்கே	tamil
shareef	latin
ہيں	arabic
అభ్యర్థి	telugu
gifts	latin
चौरस	deva
উপকূলীয়	ben_ass
ਨਾਭਾ	punjabi
બાળક	gujarati
ਪ੍ਰਭੂ	punjabi
विनंती	deva
बर्षको	deva
plain	latin
svg	latin
চব্বিশ	ben_ass
വെച്ചു	malayalam
പേരിനു	malayalam
ਘੰਟੇ	punjabi
கணக்கு	tamil
గుజరాత్	telugu
samskruti	latin
ਬਿਹਾਰ	punjabi
अपभ्रंश	deva
সহায়তা	ben_ass
حکمرانی	arabic
ਅਪਣੇ	punjabi
ਭੂਮੀ	punjabi
জামালপুর	ben_ass
કાર્યરત	gujarati
दोस्ती	deva
batch	latin
સમક્ષ	gujarati
prince	latin
শ্রমিকদের	ben_ass
twin	latin
বারের	ben_ass
ਆਪਸ	punjabi
येतील	deva
बोकेको	deva
इनको	deva
ઘરે	gujarati
పంచాయతీకి	telugu
આહાર	gujarati
1783	latin
పురుషుడు	telugu
ప్రారంభ	telugu
ఇంగ్లీషు	telugu
ఒప్పందం	telugu
విలువ	telugu
दिइन्छ	deva
প্রাইভেট	ben_ass
tape	latin
وفاقي	arabic
ಅಂಗಿ	kannada
ਸਥਿਰ	punjabi
নিয়ন্ত্রণ	ben_ass
மீன்கள்	tamil
అగ్ని	telugu
valon	latin
kakhano	latin
జరిగాయి	telugu
घन	deva
పెట్టారు	telugu
విశేషం	telugu
ఏదైనా	telugu
విషయాన్ని	telugu
கலிபோர்னியா	tamil
آمدنی	arabic
தயாரிக்கும்	tamil
tyana	latin
عيوض	arabic
ಜನಾಂಗೀಯ	kannada
સલાહ	gujarati
ಕ್ರೆಡಿಟ್	kannada
পড়তে	ben_ass
மோட்டார்	tamil
जरुरत	deva
ਪੱਖੋਂ	punjabi
श्रृङ्खलामा	deva
rachana	latin
ఉత్తర్వులు	telugu
જોડાયેલા	gujarati
சேர்மம்	tamil
ಬಳಸಿದ	kannada
মসজিদে	ben_ass
ಸಜ್ಜೆ	kannada
জোড়া	ben_ass
shanivaar	latin
શુદ્ધ	gujarati
वाहून	deva
ਮਿੰਟ	punjabi
സഹായിച്ചു	malayalam
ഗോപി	malayalam
ಸಂಸ್ಥಾನ	kannada
निःशुल्क	deva
continuously	latin
જ્યોર્જ	gujarati
বেড়েছে	ben_ass
ಗ್ರಂಥಾಲಯ	kannada
ਖੱਬੇ	punjabi
স্যাটেলাইট	ben_ass
ਲਿਖਤ	punjabi
bases	latin
municipalities	latin
ਬਿਲਕੁਲ	punjabi
ಜನರಲ್ಲಿ	kannada
ultimate	latin
అవార్డులు	telugu
এতিয়াও	ben_ass
ಪ್ರತ್ಯೇಕವಾಗಿ	kannada
সুপারিশ	ben_ass
শান্ত	ben_ass
বিক্রয়	ben_ass
सीईओ	deva
নিকটতম	ben_ass
೨೬	kannada
અંગ્રેજીમાં	gujarati
কোথায়	ben_ass
ಕೆರೆ	kannada
پیٹ	arabic
പ്രകാശം	malayalam
ನಟಿಸಿದ್ದಾರೆ	kannada
ಪೋಷಕ	kannada
प्रमुखनगराणि	deva
حجاج	arabic
મેદાન	gujarati
জানুৱাৰীত	ben_ass
छूटती	deva
بڑھا	arabic
എന്നിവിടങ്ങളിലെ	malayalam
দ্বিপাক্ষিক	ben_ass
എലിസബത്ത്	malayalam
সুনাম	ben_ass
குறித்தும்	tamil
చివరికి	telugu
దేవుడు	telugu
لازمی	arabic
بروز	arabic
کلکتہ	arabic
প্রবেশের	ben_ass
আজি	ben_ass
311	latin
વર્ષથી	gujarati
470	latin
அப்	tamil
ਰਸਤੇ	punjabi
বৈশ্বিক	ben_ass
പതിനേഴാം	malayalam
अभिनव	deva
ബന്ധിപ്പിക്കുന്ന	malayalam
തീര്	malayalam
મહિલાઓ	gujarati
పడి	telugu
തീ	malayalam
పండుగలు	telugu
ميرزا	arabic
વાતાવરણમાં	gujarati
ৰোগত	ben_ass
ഗുണം	malayalam
ആഫ്രിക്ക	malayalam
എന്തെങ്കിലും	malayalam
ഗ്രസ്	malayalam
ನೇಮಕ	kannada
অধিনায়ক	ben_ass
डॉन	deva
مقبولیت	arabic
సంబంధించి	telugu
പരമ്പരയിലെ	malayalam
ജൂനിയർ	malayalam
કોર્ટ	gujarati
கடற்படை	tamil
থৈ	ben_ass
2009ના	gujarati
రామ	telugu
ਸਬੂਤ	punjabi
പന്ത്രണ്ടാം	malayalam
पृथ्वीच्या	deva
নাগরিকদের	ben_ass
stolen	latin
مبارڪ	arabic
സംഖ്യ	malayalam
পরেও	ben_ass
इमाम	deva
નદીની	gujarati
பழுப்பு	tamil
தங்கி	tamil
ಬದುಕಿನ	kannada
শিকাগো	ben_ass
ઉંમરે	gujarati
ڳالهين	arabic
ജസ്റ്റിസ്	malayalam
வீட்டுக்கு	tamil
ശക്തമായി	malayalam
സംവിധാനത്തിൽ	malayalam
ہٹ	arabic
الرحمان	arabic
વિજયનગર	gujarati
विराजमान	deva
నం	telugu
సరైన	telugu
পোষণ	ben_ass
ਪਸ਼ੂ	punjabi
ಪೂರ್ವದ	kannada
பிந்தைய	tamil
ఉండేవి	telugu
bay	latin
மலையாளத்	tamil
شہباز	arabic
நாடுகளிலும்	tamil
ಮುದ್ರಣ	kannada
Wang	latin
আপিল	ben_ass
കിരീടം	malayalam
آج	arabic
மூர்த்தி	tamil
ക്വാണ്ടം	malayalam
சகோதரி	tamil
ஒருவரை	tamil
இலட்சம்	tamil
নম্বরে	ben_ass
ভয়	ben_ass
ಅಂದು	kannada
ನಗರಗಳಲ್ಲಿ	kannada
khela	latin
જાણકારી	gujarati
ಗ್ರಾಹಕರ	kannada
ಪ್ರವಾಹ	kannada
దూరంగా	telugu
তেন্তে	ben_ass
کاڌو	arabic
ਕ੍ਰਿਸ਼ਨ	punjabi
धुरीमा	deva
శంకర్	telugu
చేసుకున్నారు	telugu
واڌ	arabic
રક્ત	gujarati
வருடங்களுக்கு	tamil
આશા	gujarati
વિશ્વભરમાં	gujarati
ಕವಿಗಳು	kannada
তলা	ben_ass
Rise	latin
நிறுவனங்களில்	tamil
ಮದ್ರಾಸ್	kannada
ਬਲਕਿ	punjabi
ఇప్పటి	telugu
పార్లమెంటు	telugu
ਗੁਰਬਾਣੀ	punjabi
منی	arabic
আরোহণ	ben_ass
1797	latin
விருதுகளை	tamil
ஆதரவாக	tamil
निकलती	deva
પડશે	gujarati
ಗುಪ್ತ	kannada
بلے	arabic
మరిన్ని	telugu
விளையாடும்	tamil
પ્રોગ્રામ	gujarati
ਇਲਾਕਾ	punjabi
ജീവിതവും	malayalam
murdered	latin
સામગ્રી	gujarati
شہزادہ	arabic
औषधोपचार	deva
ಮೆಂತೆ	kannada
ಕಟ್ಟಡದ	kannada
இழப்பு	tamil
பரிசோதனை	tamil
माथी	deva
गतः	deva
kuti	latin
শ্ৰীমন্ত	ben_ass
लघुकथाहरू	deva
என்பவரை	tamil
ದುರ್ಗಾದೇವಿ	kannada
289	latin
untundi	latin
મેઘરજ	gujarati
পয়েন্ট	ben_ass
સરહદ	gujarati
ఉపయోగించి	telugu
করান	ben_ass
ਪੌਦੇ	punjabi
आयसीसी	deva
సాయంత్రం	telugu
ৰাজনীতি	ben_ass
anyatam	latin
ಪರಿಣಾಮಕಾರಿ	kannada
ઉતરી	gujarati
bearing	latin
میڈیسن	arabic
गोड	deva
జట్టు	telugu
Mia	latin
ത്ത്	malayalam
ইতোমধ্যে	ben_ass
ಕಾಯಿಪಲ್ಯ	kannada
تیمور	arabic
legacy	latin
বাৰ্ষিক	ben_ass
অবলম্বন	ben_ass
maar	latin
ವೈದ್ಯ	kannada
പറയുന്നുണ്ട്	malayalam
১৮৮৮	ben_ass
લંબાઈ	gujarati
اوائل	arabic
ದ್ವೀಪ	kannada
சாமி	tamil
دير	arabic
ਕੋਲੋਂ	punjabi
ദേവരാജൻ	malayalam
Jefferson	latin
आलेख	deva
mawatt	latin
ಮುದ್ದೇಬಿಹಾಳ	kannada
خزانہ	arabic
ஆஞ்சநேயர்	tamil
ghoshit	latin
sant	latin
cargo	latin
চারপাশে	ben_ass
ચાર્લ્સ	gujarati
पर्वतीय	deva
அண்ணன்	tamil
സമുദ്രനിരപ്പിൽ	malayalam
ক্লিক	ben_ass
mg	latin
গ্ৰন্থৰ	ben_ass
ಸೈನ್ಯ	kannada
پبلک	arabic
ਕਲਾਸ	punjabi
पार्टनर	deva
உற்பத்தியில்	tamil
জ্যোতি	ben_ass
بناتے	arabic
கற்றார்	tamil
નહોતી	gujarati
છેવટે	gujarati
wrestling	latin
অৱশেষত	ben_ass
પર્વતમાળાના	gujarati
தெரிவித்து	tamil
ਤਰੱਕੀ	punjabi
નાનું	gujarati
पार्टीले	deva
સોડિયમ	gujarati
বাৰ	ben_ass
அவ்வளவு	tamil
போர்கள்	tamil
اقدام	arabic
ശരീരത്തിന്റെ	malayalam
ਇਨਕਾਰ	punjabi
మాట్లాడుతూ	telugu
ملندو	arabic
રોબર્ટ	gujarati
यवतमाळ	deva
યુરોપમાં	gujarati
মধু	ben_ass
আৰম্ভণি	ben_ass
രണ്ടായി	malayalam
समस्याएं	deva
समुचित	deva
న్	telugu
വ്യാപിച്ചു	malayalam
தினசரி	tamil
سہولیات	arabic
ಕ್ರಾಸ್	kannada
રાજ્યનો	gujarati
శివుడు	telugu
നാ	malayalam
ਨਾਟਕਾਂ	punjabi
ਉੱਤਮ	punjabi
பிரதி	tamil
సహాయ	telugu
کھلاڑیوں	arabic
ஆனா	tamil
হাইস্কুল	ben_ass
ਮੰਨੇ	punjabi
taiyaari	latin
தேங்காய்	tamil
ਛੇਤੀ	punjabi
सूट	deva
ਹੀਰ	punjabi
વિલિયમ	gujarati
Ernest	latin
ಕಾಲೇಜಿನ	kannada
ਬੇਦੀ	punjabi
બાકીના	gujarati
ਬਾਨੀ	punjabi
مارا	arabic
ബേബി	malayalam
விதை	tamil
எவ்வித	tamil
ராயல்	tamil
সাহস	ben_ass
അഭിപ്രായത്തിൽ	malayalam
ಗಂಟೆಗಳ	kannada
அதற்குப்	tamil
മൂല്യം	malayalam
রেজা	ben_ass
ఉండడం	telugu
پٔتِم	arabic
زرداری	arabic
திறனை	tamil
ਲਾਭ	punjabi
देणारी	deva
നല്ലൊരു	malayalam
પ્રાકૃતિક	gujarati
শিবের	ben_ass
ജോഡി	malayalam
ਚਾਰਲਸ	punjabi
অভাবে	ben_ass
ڪپ	arabic
વિપરીત	gujarati
সবজি	ben_ass
ज़मीन	deva
ટોચ	gujarati
ಚರ್ಮ	kannada
ਮਿਸ	punjabi
শৰীৰৰ	ben_ass
ਸੱਤਾ	punjabi
સંભવિત	gujarati
ಬೇಗ	kannada
கூடுதலான	tamil
ভিত্তিত	ben_ass
HP	latin
غالباً	arabic
सङ्घको	deva
কাপে	ben_ass
நகருக்கு	tamil
நிலைமை	tamil
علاحدہ	arabic
ఉప్పు	telugu
ಆಫ್ರಿಕನ್	kannada
બનાવવાની	gujarati
కావడం	telugu
ക്ഷേത്രമാണ്	malayalam
બંધારણ	gujarati
സന്ദേശം	malayalam
இளையராஜா	tamil
ನಿರ್ಮಾಪಕ	kannada
Ruth	latin
quotes	latin
మానసిక	telugu
പ്രതി	malayalam
തമിഴ്നാട്ടിലെ	malayalam
کیو	arabic
నటించింది	telugu
செலவில்	tamil
عبید	arabic
ਤੇਜ਼ੀ	punjabi
مؤرخ	arabic
ప్రధాని	telugu
ದೃಷ್ಟಿ	kannada
ਸਮਾਜਵਾਦੀ	punjabi
குறையும்	tamil
શક્યા	gujarati
ಮಾಡಿದನು	kannada
பெண்களை	tamil
Colony	latin
ಸಂಸ್ಥೆಯನ್ನು	kannada
దాకా	telugu
baaz	latin
ಲೂಯಿಸ್	kannada
प्रातः	deva
judgment	latin
મોટાભાગની	gujarati
বিদায়	ben_ass
ਦਬਾਅ	punjabi
મેળવ્યું	gujarati
ஏழை	tamil
આરોપ	gujarati
தோராயமாக	tamil
గుర్తిస్తూ	telugu
prastut	latin
ഭാസ്കരൻ	malayalam
મંદિરમાં	gujarati
neighboring	latin
জনগণনা	ben_ass
વાંચન	gujarati
2008ع	arabic
જિલ્લાનો	gujarati
अप्रत्यक्ष	deva
ਰਸਤਾ	punjabi
தாக்கத்தை	tamil
பிறர்	tamil
অবাক	ben_ass
രാജൻ	malayalam
ఆధారాలు	telugu
Rick	latin
ప్రకటించింది	telugu
ദിവസത്തെ	malayalam
മാത്രമായിരുന്നു	malayalam
غازي	arabic
سرگرمیاں	arabic
शायर	deva
विद्यालयों	deva
పరుగులు	telugu
വിദ്യ	malayalam
rajyon	latin
ఇచ్చింది	telugu
കരിയർ	malayalam
ത്തു	malayalam
விளக்கும்	tamil
نظريي	arabic
রফিকুল	ben_ass
ఆదాయం	telugu
ٽڪر	arabic
Treatment	latin
பெற்றன	tamil
ਨਿਰਧਾਰਤ	punjabi
darasal	latin
nutrition	latin
ഇന്ത്യയിലും	malayalam
ڊرامو	arabic
Understanding	latin
മരിയ	malayalam
489	latin
ਗਰਭ	punjabi
ಅದಕ್ಕಿಂತ	kannada
ਸਵਾਲ	punjabi
മാത്രമായി	malayalam
পরিস্থিতিতে	ben_ass
പ്രതിമ	malayalam
ਦਵਾਈਆਂ	punjabi
الرحمٰن	arabic
نفسیات	arabic
नेमणूक	deva
rojgaar	latin
مديني	arabic
identical	latin
দ্বি	ben_ass
337	latin
ਅਰਜਨ	punjabi
অভিজাত	ben_ass
राशी	deva
సాగు	telugu
சுரங்கள்	tamil
ക്രിസ്തീയ	malayalam
ಲೆಕ್ಕ	kannada
মিঃ	ben_ass
স্বাগত	ben_ass
கம்பெனி	tamil
பாம்பு	tamil
నమ్మకం	telugu
ಮಂದಿರ	kannada
ஸ்	tamil
ਲਗਦਾ	punjabi
1975ء	arabic
நாராயணன்	tamil
পাৰত	ben_ass
ಉತ್ಪನ್ನಗಳನ್ನು	kannada
eldest	latin
ওয়েলস	ben_ass
అందమైన	telugu
అమ్మాయి	telugu
ಕಾರ್ಮಿಕರ	kannada
అధికారం	telugu
بزرگن	arabic
શિખર	gujarati
नेपोलियन	deva
சரஸ்வதி	tamil
દૂધ	gujarati
చేసుకున్నాడు	telugu
અભયારણ્ય	gujarati
حب	arabic
फर्जी	deva
ਭਵਨ	punjabi
न्यायालयात	deva
பருத்தி	tamil
ਪ੍ਰੋਜੈਕਟ	punjabi
सोमनाथ	deva
നിലനിൽക്കുന്ന	malayalam
ক্ষেত্রেও	ben_ass
3500	latin
بيٺل	arabic
மேற்கொள்ள	tamil
ಒಳಗೊಂಡಿವೆ	kannada
പ്രധാനം	malayalam
Teaching	latin
অজ্ঞাত	ben_ass
சமூகத்தின்	tamil
রহিম	ben_ass
ਰੱਦ	punjabi
ਖੇਡੇ	punjabi
ಪ್ರೀಮಿಯರ್	kannada
కొంతకాలం	telugu
மட்டத்தில்	tamil
സ്റ്റേഡിയം	malayalam
ಮಹತ್ವ	kannada
అయ్యాయి	telugu
সঠিকভাবে	ben_ass
ہاشم	arabic
পদাতিক	ben_ass
grams	latin
آباديءَ	arabic
kamishan	latin
चिली	deva
resolved	latin
Julian	latin
বর্গকিলোমিটার	ben_ass
కుమారులు	telugu
দৰেই	ben_ass
தேசம்	tamil
ਜਵਾਨ	punjabi
కనిపిస్తాయి	telugu
কম্পিউটারের	ben_ass
ಐದನೇ	kannada
അഭിനയത്തിന്	malayalam
સખત	gujarati
શાખા	gujarati
விளங்கினார்	tamil
مددگار	arabic
વીમા	gujarati
વાંકાનેર	gujarati
ਸੰਧੂ	punjabi
হলের	ben_ass
দখলে	ben_ass
Jennifer	latin
हुदैन	deva
ಜಯ	kannada
প্রত্যেকটি	ben_ass
ശ്രീലങ്കൻ	malayalam
प्रश्	deva
ਗਾਉਣ	punjabi
নেতৃবৃন্দ	ben_ass
ਪ੍ਰਾਈਵੇਟ	punjabi
ಯುರೋಪಿನ	kannada
ایبٹ	arabic
ఇచ్చాడు	telugu
સાવલી	gujarati
عبدالقادر	arabic
ਗ੍ਰਹਿਣ	punjabi
വരണ്ട	malayalam
ਸੰਸਕ੍ਰਿਤੀ	punjabi
इत्यस्याः	deva
ਢਾਂਚੇ	punjabi
failing	latin
ازیں	arabic
ജാവ	malayalam
తల్లిదండ్రులు	telugu
तळ	deva
ফলের	ben_ass
ಅಟ್ಲಾಂಟಿಕ್	kannada
பாதுகாக்க	tamil
3G	latin
೧೯೯೯	kannada
இழந்த	tamil
శ్రీకాకుళంలోనూ	telugu
کلیسا	arabic
వివరణ	telugu
घरे	deva
શાહી	gujarati
ਗ਼ਜ਼ਲ	punjabi
ਅਮਲ	punjabi
ജർമ്മനിയിലെ	malayalam
పార్క్	telugu
ਸੋਸ਼ਲ	punjabi
পারস্য	ben_ass
আদান	ben_ass
सजीव	deva
قرارداد	arabic
నిర్మల్	telugu
ராஜஸ்தான்	tamil
ਅੰਤਮ	punjabi
பெரும்பான்மை	tamil
నిన్ను	telugu
wheels	latin
লোৱাৰ	ben_ass
ফিরিয়ে	ben_ass
ਕਣਕ	punjabi
ಹಾಕುವ	kannada
నే	telugu
ತಂತ್ರಾಂಶ	kannada
বেছিভাগ	ben_ass
हालेर	deva
ಆಯ್ಕೆಯಾದರು	kannada
ਲਾਜ਼ਮੀ	punjabi
را	arabic
جسٽس	arabic
ಗಂಟೆ	kannada
গলা	ben_ass
جادو	arabic
ಸೂಚನೆ	kannada
పూజ	telugu
ਗਰਮੀਆਂ	punjabi
ਮੁਢਲੀ	punjabi
പതിനൊന്നാം	malayalam
తమకు	telugu
दानव	deva
رضي	arabic
એક્સપ્રેસ	gujarati
मानद	deva
ਗੱਡੀ	punjabi
ಕ್ರೀಡೆ	kannada
थारू	deva
பாட்டு	tamil
تاجر	arabic
قطار	arabic
ਉਹਨਾ	punjabi
একো	ben_ass
ਮੁਦਰਾ	punjabi
সুবিধার	ben_ass
এটাকে	ben_ass
ಶಾಸ್ತ್ರದ	kannada
ಕೇರಳದ	kannada
ഘട്ടം	malayalam
भक्ती	deva
একধরনের	ben_ass
ભરતી	gujarati
chemicals	latin
તફાવત	gujarati
પ્રકારો	gujarati
നയിച്ചു	malayalam
విజయ	telugu
પહોંચે	gujarati
386	latin
ਚਲਾਇਆ	punjabi
ਮਾਰਿਆ	punjabi
پتو	arabic
সম্বন্ধীয়	ben_ass
બેન્ક	gujarati
hitting	latin
ছিলাম	ben_ass
ਦੌਰਾ	punjabi
मुघल	deva
കേന്ദ്രമാണ്	malayalam
آرمینیا	arabic
பிளாக்	tamil
ভাস্কৰ	ben_ass
सम्प्रति	deva
গুৱাহাটীত	ben_ass
பாத்திரம்	tamil
బలమైన	telugu
આશ્રમ	gujarati
பாணியில்	tamil
چادر	arabic
મળશે	gujarati
റോക്ക്	malayalam
ਰਾਇਲ	punjabi
عيسيٰ	arabic
অভিবাসী	ben_ass
ಆಮದು	kannada
अध्यक्षपद	deva
పరిశ్రమ	telugu
ಅನ್	kannada
جزیرے	arabic
కెరీర్	telugu
জজ	ben_ass
દરજ્જો	gujarati
ఐదుగురు	telugu
తీవ్రమైన	telugu
ప్రారంభమైంది	telugu
জার্নাল	ben_ass
ആനന്ദ്	malayalam
అపరాలు	telugu
সেক্টর	ben_ass
थोड़ा	deva
આખરે	gujarati
ਹੋਰਨਾਂ	punjabi
ડેવિડ	gujarati
જોડાયેલ	gujarati
દસાડા	gujarati
दाहाल	deva
প্রযুক্তিগত	ben_ass
உருவாகி	tamil
సభలో	telugu
இதைக்	tamil
उनीहरु	deva
ਬਰਤਾਨੀਆ	punjabi
ഇംഗ്ലണ്ടിൽ	malayalam
చేరాడు	telugu
લાવવા	gujarati
আল্লাহ্	ben_ass
রানার	ben_ass
రాష్ట్రపతి	telugu
ખંડ	gujarati
பெறப்பட்ட	tamil
Too	latin
വിത്തുകൾ	malayalam
భాషలలో	telugu
زڪوات	arabic
જ્હોન	gujarati
ਦੀਵਾਨ	punjabi
స్థాపించారు	telugu
ਮੁਕੰਮਲ	punjabi
राज्यमंत्री	deva
چور	arabic
nickname	latin
ਸਾਡਾ	punjabi
clip	latin
શાસ્ત્રીય	gujarati
ફીટ	gujarati
ગણી	gujarati
ಸಿವಿಲ್	kannada
enhanced	latin
எனப்படுவது	tamil
புனே	tamil
lakshmi	latin
ਪ੍ਰਕਿਰਤੀ	punjabi
പഠിക്കാൻ	malayalam
ललिता	deva
সফলভাবে	ben_ass
राती	deva
جوڳي	arabic
ஊடக	tamil
ਰਿਸ਼ਤਾ	punjabi
एकक	deva
అనుమతి	telugu
बुलढाणा	deva
ঠাকুরের	ben_ass
కీలక	telugu
చేసుకొని	telugu
पद्मावती	deva
പോകാൻ	malayalam
पर्	deva
Lead	latin
సరిహద్దు	telugu
संध्याकाळी	deva
সমর্থিত	ben_ass
ఎత్తైన	telugu
പ്രചോദനം	malayalam
સ્રોત	gujarati
દરવાજા	gujarati
ಹಳ್ಳಿ	kannada
ದಾನ	kannada
ചെയ്തിരിക്കുന്നു	malayalam
islami	latin
ఏకైక	telugu
ভাড়া	ben_ass
nangas	latin
اِسی	arabic
સેટ	gujarati
కే	telugu
ਜਾਇਦਾਦ	punjabi
1993ع	arabic
ਕਿਰਤ	punjabi
Actually	latin
వాటర్	telugu
Mystery	latin
ಶೇಕಡ	kannada
દવાઓ	gujarati
ਤੇਰੀ	punjabi
பயண	tamil
ప్రపంచంలోని	telugu
نغمہ	arabic
मास्टर्स	deva
CPM	latin
মিলিয়ে	ben_ass
ಆಟವನ್ನು	kannada
স্নায়ু	ben_ass
સ્ટ્રીટ	gujarati
ਕੋਲੰਬੀਆ	punjabi
दर्शनं	deva
વાંસદા	gujarati
ਰਾਹੀ	punjabi
જવાની	gujarati
شعراء	arabic
ہوچکی	arabic
శుద్ధ	telugu
গরুর	ben_ass
ਮਕਸਦ	punjabi
જણાય	gujarati
மாற்றும்	tamil
ਦਵਾਈ	punjabi
ڪميونسٽ	arabic
আয়তনের	ben_ass
ಕಾಲು	kannada
ಒಳಗಿನ	kannada
صديق	arabic
నిజానికి	telugu
પશ્ચિમમાં	gujarati
పోయింది	telugu
രൂപീകരിച്ചു	malayalam
தேவாரம்	tamil
পিস	ben_ass
মোশাররফ	ben_ass
soorat	latin
Perfect	latin
தொகுப்பில்	tamil
മേജർ	malayalam
ਬਣਦੇ	punjabi
تحصیلیں	arabic
यांच्याकडून	deva
bie	latin
minerals	latin
مدفون	arabic
বিপদ	ben_ass
ਖ਼ਿਲਾਫ਼	punjabi
એકબીજા	gujarati
زلزلے	arabic
ಮಾ	kannada
brush	latin
పోటీలలో	telugu
நேபாளத்தின்	tamil
তুলেছিলেন	ben_ass
ਅਸਥਾਨ	punjabi
کٽي	arabic
لارڈ	arabic
करायची	deva
స్క్రీన్	telugu
தொல்பொருள்	tamil
રંગના	gujarati
ਸਹਿਤ	punjabi
ਚੋਪੜਾ	punjabi
ಅಂತ್ಯದಲ್ಲಿ	kannada
ਨਸਲੀ	punjabi
tumor	latin
பொருத்தமான	tamil
ഡാം	malayalam
சாகித்திய	tamil
ਐੱਨ	punjabi
asset	latin
सुरुवातीच्या	deva
દહેગામ	gujarati
દોરી	gujarati
വാസുദേവൻ	malayalam
ചെറുതും	malayalam
অসমের	ben_ass
ਦਹਾਕਿਆਂ	punjabi
నేతలు	telugu
കുറഞ്ഞത്	malayalam
કઈ	gujarati
ഏകദിന	malayalam
రా	telugu
پرندے	arabic
ഭൂമിയിലെ	malayalam
அழைக்கப்பட்ட	tamil
માર્કેટિંગ	gujarati
حکومتوں	arabic
വാലി	malayalam
வருமான	tamil
বিচারে	ben_ass
എത്തുന്നു	malayalam
کھیلا	arabic
nati	latin
ব্যৱহাৰৰ	ben_ass
ਫਾਰਮੂਲਾ	punjabi
ഗണ്യമായ	malayalam
ব্যবহারে	ben_ass
થોમસ	gujarati
નકારાત્મક	gujarati
ઝેરી	gujarati
ടൗൺ	malayalam
ശേഷമുള്ള	malayalam
1650	latin
ਕਿੰਗ	punjabi
উৎসর্গ	ben_ass
ಸೈನ್ಯದ	kannada
ਯਾਨੀ	punjabi
ఏళ్ల	telugu
விக்ரம்	tamil
માન્ય	gujarati
ਆਤਮ	punjabi
ਮੁਕਤੀ	punjabi
ലണ്ടനിൽ	malayalam
వ్యాప్తంగా	telugu
महीना	deva
ஒருவேளை	tamil
ജർമ്മനി	malayalam
মিজানুর	ben_ass
ఇంటర్	telugu
ਇਨਕਲਾਬੀ	punjabi
சிறந்து	tamil
পালক	ben_ass
ഉണ്ടാകുന്നത്	malayalam
ਬਦਲੇ	punjabi
ਸਿੱਧਾ	punjabi
ਲੱਗਣ	punjabi
1766	latin
ధర	telugu
ആസൂത്രണം	malayalam
విజయనగర	telugu
ಕೌಂಟಿ	kannada
पृथ्वीमा	deva
குறிப்புகளும்	tamil
ಪಟ್ಟಿಯನ್ನು	kannada
നാൾ	malayalam
વહે	gujarati
Newcastle	latin
ਚੈਂਪੀਅਨ	punjabi
ਮੁਲਕਾਂ	punjabi
नेवारी	deva
આઉટ	gujarati
ਟੈਲੀਵਿਜਨ	punjabi
மகாராட்டிர	tamil
নিয়েছিল	ben_ass
1998ع	arabic
رابرٹ	arabic
રદ	gujarati
எல்லைகளாக	tamil
Chronicle	latin
معتبر	arabic
પોર્ટ	gujarati
ساٹھ	arabic
ನಿರ್ವಹಣೆಯ	kannada
ഖാന്റെ	malayalam
ਅਗਲੀ	punjabi
inherited	latin
વર્ગીકૃત	gujarati
ਬਣਾਉਂਦੇ	punjabi
रहेकाे	deva
Distinguished	latin
Sindhi	latin
صدارتي	arabic
कहलाते	deva
செயல்பட	tamil
ఎత్తున	telugu
જહાજ	gujarati
பூச்சி	tamil
جنتا	arabic
সনাক্ত	ben_ass
owns	latin
maahaul	latin
বাহন	ben_ass
ರಚನೆಗಳು	kannada
രചിച്ചത്	malayalam
کفر	arabic
ప్రణాళిక	telugu
ਜੀਵਿਤ	punjabi
শাসনৰ	ben_ass
పెరుగుతుంది	telugu
നാരായണ	malayalam
જીવનના	gujarati
منسوخ	arabic
ಹೋಲುವ	kannada
جائزو	arabic
ایڈیٹر	arabic
चालुक्य	deva
कैप्टन	deva
رنگن	arabic
مهم	arabic
پٽن	arabic
peaked	latin
গাই	ben_ass
গঠনে	ben_ass
ಆಟಗಳು	kannada
ಪ್ರದರ್ಶನದ	kannada
बगैर	deva
हिरव्या	deva
distant	latin
डिपार्टमेंट	deva
માર્ગદર્શન	gujarati
ഇലക്ട്രോൺ	malayalam
ಬ್ಯಾಂಕು	kannada
बहीण	deva
కార్బన్	telugu
উজনি	ben_ass
વાઘ	gujarati
ನ್ಯೂಜಿಲೆಂಡ್	kannada
ਭਰੀ	punjabi
फाल्गुन	deva
ಯಾವುದು	kannada
ਨਿੱਕੀ	punjabi
మహిళ	telugu
ಆಗಿರುವ	kannada
సంరక్షణా	telugu
चालते	deva
ਪੁੱਤ	punjabi
এগুলির	ben_ass
ਮਿਆਦ	punjabi
চওড়া	ben_ass
2007ع	arabic
لتھووینیا	arabic
રાખવાની	gujarati
வாழ்வின்	tamil
climbing	latin
ਨਿਕਲ	punjabi
സംസ്ഥാനത്തിലെ	malayalam
পরিপূর্ণ	ben_ass
ജനതയുടെ	malayalam
गोरा	deva
എയർലൈൻസ്	malayalam
ਚੁੰਬਕੀ	punjabi
വ്യവസായം	malayalam
વૃક્ષો	gujarati
ಹೋಮ್	kannada
રજુ	gujarati
পুনরুদ্ধার	ben_ass
ವಿರುದ್ದ	kannada
nann	latin
ਕਨੇਡਾ	punjabi
پوئين	arabic
பாருங்கள்	tamil
কাষত	ben_ass
ವಿಧಗಳು	kannada
समितिमा	deva
मेलबर्न	deva
slight	latin
મેનેજમેન્ટ	gujarati
পূবে	ben_ass
શાંત	gujarati
വച്ചാണ്	malayalam
అత్యధికంగా	telugu
ചേർന്നതാണ്	malayalam
ਖਿੱਚ	punjabi
కాయగూరలు	telugu
வம்ச	tamil
سونهن	arabic
வேளைகளில்	tamil
మహేష్	telugu
ಕನಸು	kannada
recognised	latin
ਜੇਮਜ਼	punjabi
موڪلي	arabic
സൂചന	malayalam
పోయి	telugu
बारामती	deva
एरलाइन्स	deva
সৈন্যরা	ben_ass
धर्मः	deva
উৎক্ষেপণ	ben_ass
प्रसंगी	deva
એમનું	gujarati
ಮಲಯಾಳಂ	kannada
അസീസ്	malayalam
ਫਾਰਸੀ	punjabi
સંગ્રહાલય	gujarati
ಆರ್ಥರ್	kannada
ਮਸਜਿਦ	punjabi
திருப்பி	tamil
উদ্বুদ্ধ	ben_ass
adhikam	latin
Leon	latin
surrender	latin
அமைச்சகம்	tamil
ಟೆಕ್ನಾಲಜಿ	kannada
রোডে	ben_ass
சமூகப்	tamil
শুনানি	ben_ass
ಅರ್ಹತೆ	kannada
2వపేజీ	telugu
ব্যৱসায়িক	ben_ass
avarute	latin
ਵਜੇ	punjabi
സിന്റെ	malayalam
விலையில்	tamil
ప్రారంభించింది	telugu
കൊട്ടാരത്തിൽ	malayalam
katl	latin
गर्नुपर्दछ	deva
ആർമി	malayalam
દાન	gujarati
ಮೈಕ್ರೋಸಾಫ್ಟ್	kannada
శ్రీకాకుళంలో	telugu
ਪੌਦਿਆਂ	punjabi
ورلڊ	arabic
midnight	latin
വയസിൽ	malayalam
പരീക്ഷണങ്ങൾ	malayalam
വീട്ടില്	malayalam
భారతి	telugu
नेहरु	deva
তৃতীয়াংশ	ben_ass
ಮುಖ್ಯಸ್ಥ	kannada
નાયક	gujarati
केंद्रों	deva
સાંતલપુર	gujarati
ਭਾਸ਼ਣ	punjabi
સ્નાતક	gujarati
ಪಕ್ಷಗಳು	kannada
ನಿರ್ಮಿಸಿದರು	kannada
ದೇವತೆ	kannada
गर्दथ्यो	deva
ఉపయోగించే	telugu
ਸਪੈਸ਼ਲ	punjabi
lagati	latin
സ്ഥാപിതമായത്	malayalam
अकरा	deva
અભિયાન	gujarati
ಪತ್ರಿಕಾ	kannada
ਯੂਨਾਨ	punjabi
بون	arabic
ಕೇಂಬ್ರಿಡ್ಜ್	kannada
রাখুন	ben_ass
నెల్లిమర్లలోను	telugu
അധികാരത്തിൽ	malayalam
বন্দি	ben_ass
سائي	arabic
dialect	latin
ਵਿਵਹਾਰ	punjabi
1996ع	arabic
ਹੋਣਗੇ	punjabi
அதைச்	tamil
റോഡിൽ	malayalam
संस्थेत	deva
മുസിരിസ്	malayalam
લાલપુર	gujarati
گروهه	arabic
કપૂર	gujarati
اوچتو	arabic
ജല	malayalam
பயன்படுத்தப்பட்ட	tamil
ਸੁਤੰਤਰਤਾ	punjabi
سانچے	arabic
فسادات	arabic
నందు	telugu
इसपर	deva
ਲੜਕੀਆਂ	punjabi
সাক্ষ্য	ben_ass
চাউল	ben_ass
અમલ	gujarati
संपत्ती	deva
مسئلو	arabic
ಹೇಳುವಂತೆ	kannada
সংঘর্ষের	ben_ass
ਮੀਰ	punjabi
ಯವರು	kannada
ರತ್ನ	kannada
അപേക്ഷ	malayalam
والي	arabic
बनेर	deva
కారు	telugu
عالمگير	arabic
வட்டி	tamil
নির্মান	ben_ass
মরদেহ	ben_ass
atal	latin
ಟೆಕ್ಸಾಸ್	kannada
ગેમ	gujarati
আনোয়ার	ben_ass
అర్జున్	telugu
آرٹ	arabic
تونس	arabic
പ്രൈസ്	malayalam
కళ్యాణ్	telugu
ਨਵਾਬ	punjabi
കേവലം	malayalam
பெறவில்லை	tamil
రైల్వేలు	telugu
ચીકુ	gujarati
సహాయంతో	telugu
ಇನ್ನಿಂಗ್ಸ್	kannada
હવામાન	gujarati
ਬਿਮਾਰੀਆਂ	punjabi
ਸਾਈਟ	punjabi
કાંઠે	gujarati
Sussex	latin
ਕਿੰਗਡਮ	punjabi
ರಾಗ	kannada
अपार	deva
रॉकेट	deva
پڪي	arabic
ఉమ్మడి	telugu
वाहत	deva
விட்டுக்	tamil
पदव्युत्तर	deva
கட்டிட	tamil
ફર્યા	gujarati
ಲೇಖನಗಳನ್ನು	kannada
ਆਇਰਲੈਂਡ	punjabi
લી	gujarati
ವೆಲ್	kannada
प्रयोगः	deva
அதிரடி	tamil
১৮৭৬	ben_ass
அமெரிக்கர்கள்	tamil
ಪ್ರಾಮುಖ್ಯತೆ	kannada
ਧਨ	punjabi
খ্যাতনামা	ben_ass
ਤਖ਼ਤ	punjabi
naanu	latin
२०३०	deva
ಅಧಿಕಾರಿಗಳ	kannada
ਹੱਥਾਂ	punjabi
നിലയം	malayalam
రాయలసీమ	telugu
बुजुर्ग	deva
ਮੰਨਦਾ	punjabi
பேராசிரியராக	tamil
ટેનિસ	gujarati
હોવું	gujarati
ആരംഭിക്കുകയും	malayalam
رياستي	arabic
Manoj	latin
अनमोल	deva
ક્રાંતિ	gujarati
లిమిటెడ్	telugu
ٹو	arabic
അക്ഷരങ്ങൾ	malayalam
రెండూ	telugu
ਲਿਖ	punjabi
மறுநாள்	tamil
సంస్కృతం	telugu
మొదలైంది	telugu
નજીકમાં	gujarati
സ്ഥാപിതമായി	malayalam
പനി	malayalam
இருக்கின்றனர்	tamil
ಸುರಕ್ಷಿತ	kannada
கொள்ளுங்கள்	tamil
ಡೆಲ್	kannada
موقعو	arabic
پراڻن	arabic
പഠിക്കുന്ന	malayalam
dalian	latin
انکا	arabic
বুদ্ধের	ben_ass
തൊട്ടു	malayalam
પુનઃ	gujarati
रामचरितमानस	deva
Dover	latin
ಕೆಲಸಗಳನ್ನು	kannada
असतांना	deva
ഒരുപോലെ	malayalam
માર્યા	gujarati
ਇਕੱਠਾ	punjabi
1941ء	arabic
అందువల్ల	telugu
સમાજના	gujarati
பாதுகாப்பான	tamil
ಕಂಪೆನಿಯ	kannada
கிராண்ட்	tamil
ڪڻڪ	arabic
ചെറുകിട	malayalam
ઋષિ	gujarati
ಬರ್ಲಿನ್	kannada
encyclopedia	latin
روڪڻ	arabic
masters	latin
సంస్థల	telugu
பயன்படுகின்றது	tamil
سرے	arabic
બાબરા	gujarati
ਬੰਦੇ	punjabi
দৃষ্টিকোণ	ben_ass
ਪਾਠਕ	punjabi
ਸ਼ੇਖ	punjabi
સૂચન	gujarati
എന്നൊക്കെ	malayalam
മനുഷ്യരുടെ	malayalam
ಪೂರಕ	kannada
ਟੈਨਿਸ	punjabi
kite	latin
ফ্রান্সিস	ben_ass
ಆಪಲ್	kannada
இல்ல	tamil
કાળો	gujarati
பள்ளியின்	tamil
పాటల	telugu
यादा	deva
కామారెడ్డి	telugu
ತುಂಬಿ	kannada
ಉಪಕರಣಗಳು	kannada
1999ع	arabic
వికారాబాద్	telugu
اسود	arabic
বললে	ben_ass
తానే	telugu
সমাহিত	ben_ass
തിരഞ്ഞെടുപ്പുകൾ	malayalam
ڪنٽرول	arabic
ਇੰਨਾ	punjabi
ಪರ್ಲ್	kannada
1920ع	arabic
2010ರ	kannada
ਕਰਤਾਰ	punjabi
ರಹಿತ	kannada
Towns	latin
naku	latin
ਕਿਨਾਰੇ	punjabi
ਇੰਟਰਵਿਊ	punjabi
বিকিরণ	ben_ass
காப்பீடு	tamil
മേഖലകൾ	malayalam
निक	deva
യാണ്	malayalam
இலவசமாக	tamil
ਜਵਾਨੀ	punjabi
ജൂത	malayalam
మరికొన్ని	telugu
জুলাইত	ben_ass
ਲੰਬਾ	punjabi
यांच्यासह	deva
گمان	arabic
ಸ್ವರೂಪವನ್ನು	kannada
میسر	arabic
സാഹിബ്	malayalam
द्रष्टुं	deva
ಶುಕ್ರವಾರ	kannada
ফোনে	ben_ass
પ્રકૃતિ	gujarati
indica	latin
સમયગાળો	gujarati
ਸਵੇਰੇ	punjabi
ನವದೆಹಲಿ	kannada
پيشاب	arabic
ٽاور	arabic
സൈന്യത്തിന്റെ	malayalam
ಕೋಟೆಯ	kannada
ഇടയ്ക്ക്	malayalam
யோகம்	tamil
ರಾಜ್ಯಕ್ಕೆ	kannada
ਰੁਚੀ	punjabi
મુસાફરી	gujarati
وارد	arabic
ഭാഗത്തായി	malayalam
സ്വീകരിച്ച	malayalam
কমই	ben_ass
పంజాబీ	telugu
سيني	arabic
ಆರೋಗ್ಯದ	kannada
ઉકેલ	gujarati
ஞான	tamil
ખંભાળિયા	gujarati
કબજો	gujarati
આજના	gujarati
वक्र	deva
wrapped	latin
હોતા	gujarati
விளம்பரம்	tamil
ವೇದಿಕೆ	kannada
ফা	ben_ass
ಮೆಡಿಕಲ್	kannada
পাঁচজন	ben_ass
காக்கும்	tamil
స్నానం	telugu
ಕಾರಣಕ್ಕಾಗಿ	kannada
ಫಾರ್ಮ್	kannada
കായംകുളം	malayalam
ಪರಿಷತ್	kannada
रोक्न	deva
நண்பன்	tamil
ہمت	arabic
അതില്	malayalam
आक्रमक	deva
இறைச்சி	tamil
ਕਿਲੇ	punjabi
দূত	ben_ass
এরূপ	ben_ass
Animation	latin
നിയമസഭയിലെ	malayalam
ಐರಿಷ್	kannada
aaraam	latin
గూడెం	telugu
হামলায়	ben_ass
ವರ್ಣ	kannada
விளையாடிய	tamil
ప్రాంతాలను	telugu
absorbed	latin
ಒಂದಾದ	kannada
ഉദ്യാനം	malayalam
ಪಕ್ಕದ	kannada
बिमारियों	deva
ਪੰਡਿਤ	punjabi
درانی	arabic
ايسٽ	arabic
ਸੁਪਰੀਮ	punjabi
تائید	arabic
शूट	deva
ജന്മം	malayalam
Jeffrey	latin
1986ع	arabic
പ്രവാചകൻ	malayalam
اناج	arabic
ಪ್ರಕಟಣೆ	kannada
شائر	arabic
جيتري	arabic
అతనిని	telugu
عارضی	arabic
संवेदना	deva
జాబితాలో	telugu
ব্যৱস্থাৰ	ben_ass
ഇന്തോനേഷ്യൻ	malayalam
പത്തൊമ്പതാം	malayalam
ಪದ್ಮಶ್ರೀ	kannada
సాధించారు	telugu
தேவா	tamil
பாடினார்	tamil
nivu	latin
నిర్వహిస్తారు	telugu
राजद	deva
याउने	deva
স্থিতিশীল	ben_ass
अनुभाग	deva
దక్షిణాన	telugu
నెలలో	telugu
ನಿವೃತ್ತಿ	kannada
Sept	latin
انڙ	arabic
ਪੱਤੇ	punjabi
स्थानबाट	deva
పార్టీలు	telugu
শ্রেণিতে	ben_ass
ਇਹੋ	punjabi
पर्ल	deva
काटकर	deva
রশ্মি	ben_ass
ಮುಂಚೆಯೇ	kannada
ਪਰਵਾਸੀ	punjabi
चारही	deva
qareeb	latin
ಆಲಮಟ್ಟಿ	kannada
मर्सिडीज	deva
ಕಾರ್ಖಾನೆ	kannada
ఉచిత	telugu
srilanka	latin
ஆங்கிலேயர்	tamil
پوکي	arabic
پڑھے	arabic
ప్రపంచం	telugu
گذرڻ	arabic
அங்கேயே	tamil
సహకారంతో	telugu
வெளியேறி	tamil
ప్రకాష్	telugu
కథనం	telugu
ಜನಗಣತಿ	kannada
મળતો	gujarati
nominee	latin
১৮৭৮	ben_ass
तोड़ने	deva
2006ના	gujarati
ನರಸಿಂಹ	kannada
ورزی	arabic
جد	arabic
Dale	latin
బొబ్బిలి	telugu
ஈராக்	tamil
મરી	gujarati
తీసుకున్నారు	telugu
মিয়ানমার	ben_ass
अस्पष्ट	deva
સ્વાદ	gujarati
కవిత	telugu
सत्यशोधक	deva
تماڪ	arabic
ಸಿಗುವ	kannada
ಮುಂಬಯಿನ	kannada
இளவரசி	tamil
खासै	deva
ರೇಸ್	kannada
പാ	malayalam
ਇਸ਼ਾਰਾ	punjabi
డబ్బింగ్	telugu
ಜೇನು	kannada
ਫ਼ੈਸਲਾ	punjabi
१८६५	deva
જેલમાં	gujarati
పల్లిలోను	telugu
ఒక్కొక్క	telugu
முகலாய	tamil
पारेका	deva
স্থায়ীভাবে	ben_ass
మూడో	telugu
eclipse	latin
628	latin
కాంగ్రెసు	telugu
اڇو	arabic
ਇੰਦਰ	punjabi
رحمہ	arabic
ഭാഗങ്ങളിലും	malayalam
అద్భుతమైన	telugu
581	latin
ஒன்பதாம்	tamil
ਸਰਕਾਰਾਂ	punjabi
Tribes	latin
তলায়	ben_ass
interviewed	latin
ਲੰਕਾ	punjabi
ચલાવવામાં	gujarati
ಅಧ್ಯಯನವು	kannada
ശിവന്റെ	malayalam
ಶಿಕ್ಷಕರ	kannada
ਪ੍ਰੇਰਨਾ	punjabi
ദ്രാവിഡ	malayalam
பயனர்கள்	tamil
३रा	deva
রোম	ben_ass
फाटक	deva
കണ്	malayalam
आगतः	deva
গোলাপ	ben_ass
గౌరవ	telugu
નદીમાં	gujarati
കൊണ്ടുവന്നു	malayalam
સલામત	gujarati
கருப்பை	tamil
വരുമാനമാർഗ്ഗമായി	malayalam
నష్టం	telugu
ഭരതൻ	malayalam
لیئے	arabic
ਪਸ਼ੂਆਂ	punjabi
மேல்நிலைப்	tamil
சொல்லிக்	tamil
இடைவெளியில்	tamil
امرا	arabic
ಮೋಟಾರ್	kannada
ಯಾವುದೋ	kannada
మారి	telugu
విధానాన్ని	telugu
நடிகருக்கான	tamil
ಜೀವಕೋಶಗಳು	kannada
Rica	latin
ಭವಿಷ್ಯ	kannada
நிறுவனத்திற்கு	tamil
কৃষকদের	ben_ass
dilaa	latin
ٹرین	arabic
బ్రాహ్మణులు	telugu
மேற்கொள்ளும்	tamil
సీత	telugu
مريض	arabic
திருவள்ளுவர்	tamil
எழுச்சி	tamil
ಪ್ರವೃತ್ತಿ	kannada
করপোরেশন	ben_ass
459	latin
consulting	latin
ഇടത്തരം	malayalam
१०४	deva
معمولي	arabic
বৰ্ষত	ben_ass
మండలి	telugu
சரக்கு	tamil
எடுக்கப்பட்டது	tamil
Himalayas	latin
అద్దంకి	telugu
೧೯೮೯	kannada
mergedrow	latin
ಬೀಚ್	kannada
ఎందరో	telugu
ٿري	arabic
ವ್ಯವಸ್ಥೆಗಳ	kannada
क्रान्तिको	deva
ਫਿਲਮਫੇਅਰ	punjabi
സസ്യമാണ്	malayalam
فلاح	arabic
രാജ്യമാണ്	malayalam
संमेलनाच्या	deva
আমলের	ben_ass
മഹാ	malayalam
ਲਖਨਊ	punjabi
Mitra	latin
ഫോറസ്റ്റ്	malayalam
مضمونن	arabic
తద్వారా	telugu
الحاق	arabic
mega	latin
शिर	deva
ਬਿਲੀਅਨ	punjabi
ખેંચી	gujarati
কেতিয়াও	ben_ass
সুইডিশ	ben_ass
ھوا	arabic
১৮৭৭	ben_ass
ಜೂನಿಯರ್	kannada
Effect	latin
oath	latin
ಮಿಲನ್	kannada
ਸੁਰ	punjabi
gathan	latin
اپوزیشن	arabic
ఇవ్వడం	telugu
কেনা	ben_ass
دیکھو	arabic
তুলনাত	ben_ass
ഫെസ്റ്റിവൽ	malayalam
Albany	latin
వచ్చు	telugu
సూర్యుడు	telugu
ਨਿਰਧਾਰਿਤ	punjabi
श्रीकृष्णः	deva
ಘಟಕಗಳನ್ನು	kannada
ਤਰੰਗਾਂ	punjabi
Colleges	latin
ਸਰਬ	punjabi
athletic	latin
ਬ੍ਰਾਜ਼ੀਲ	punjabi
আৰ্থিক	ben_ass
కథను	telugu
সহকর্মী	ben_ass
આસામ	gujarati
effectiveness	latin
Johannes	latin
స్పష్టంగా	telugu
છૂટ	gujarati
വ്യാഖ്യാനം	malayalam
ఉపగ్రహ	telugu
ಹೆಚ್ಚಿಸುವ	kannada
ಸಂಚಾರಿ	kannada
پاتا	arabic
سانگهڙ	arabic
ગણિત	gujarati
عامل	arabic
ಕಾಂಗ್	kannada
فوجوں	arabic
iTunes	latin
পুৰাণ	ben_ass
அங்குலம்	tamil
چاهي	arabic
Manufacturing	latin
पेड़ों	deva
ಹಲವರು	kannada
நேபாளம்	tamil
கோதாவரி	tamil
ಮಂಗಳವಾರ	kannada
duuri	latin
Domain	latin
দিল্লীত	ben_ass
சொல்லின்	tamil
मांगने	deva
ਨਿਯੰਤਰਣ	punjabi
قائداعظم	arabic
মহাদেশের	ben_ass
తొలిసారిగా	telugu
బెంగాలీ	telugu
सांगितली	deva
ਪ੍ਰਤੀਸ਼ਤ	punjabi
೧೯೮೨	kannada
ਮਾਇਆ	punjabi
ਸਮਰੱਥ	punjabi
ક્યાં	gujarati
ಬ್ರ್ಯಾಂಡ್	kannada
समाजसुधारक	deva
व्यापी	deva
റോയ്	malayalam
సకల	telugu
ਵਿਚਲੀ	punjabi
ಸಂಭವಿಸಿದ	kannada
wages	latin
കോര്	malayalam
മുംബൈയിൽ	malayalam
nutrients	latin
ਮੁੰਡਾ	punjabi
প্ৰতিযোগিতাৰ	ben_ass
ڊيگهه	arabic
handful	latin
deve	latin
ఇటలీ	telugu
فرمائے	arabic
sakriy	latin
Ludwig	latin
dedication	latin
শীতের	ben_ass
சித்தூர்	tamil
بيٺو	arabic
અપ	gujarati
കണ്ണി	malayalam
ರಾಜರು	kannada
ഒഴിവാക്കി	malayalam
புராண	tamil
ਆਮਦਨ	punjabi
lip	latin
ਨੂਰ	punjabi
স্তন	ben_ass
२०३९	deva
Glen	latin
Nursing	latin
ಸತ್ತ	kannada
ഒന്നര	malayalam
ಅಂತ್ಯ	kannada
ಬಡ್ಡಿ	kannada
ಚಿ	kannada
কলাৰ	ben_ass
இணைக்கப்பட்ட	tamil
ਰੋਮਾਂਟਿਕ	punjabi
સાંજે	gujarati
ಐತಿಹಾಸಿಕವಾಗಿ	kannada
ولید	arabic
پاتے	arabic
ఇవన్నీ	telugu
همت	arabic
ಉದ್ದನೆಯ	kannada
امڪان	arabic
આવો	gujarati
எனக்குத்	tamil
ಇಂಟೆಲ್	kannada
زنده	arabic
প্রতিরোধের	ben_ass
ಮಹಾಭಾರತದ	kannada
ਖਾਲੀ	punjabi
പാർവ്വതി	malayalam
بچائڻ	arabic
బెల్లంపల్లిలోను	telugu
نیند	arabic
ಎಷ್ಟೋ	kannada
Anatomy	latin
संपदा	deva
predominantly	latin
મિનિટ	gujarati
চরিত্রটি	ben_ass
தங்கப்	tamil
प्रसिद्धानि	deva
പറഞ്ഞിരുന്നു	malayalam
દિલ્હીમાં	gujarati
Monument	latin
agrees	latin
ಶ್ವಾಸಕೋಶದ	kannada
அண்மைய	tamil
வைக்கப்பட்டுள்ளன	tamil
പരമാധികാരി	malayalam
జల	telugu
পোপ	ben_ass
ಲಕ್ಷ್ಮಿ	kannada
அழிக்க	tamil
વિભિન્ન	gujarati
ਖੂਹ	punjabi
എന്നെല്ലാം	malayalam
નિર્દેશક	gujarati
સ્વીકારી	gujarati
બચાવ	gujarati
लीक	deva
નેતાઓ	gujarati
उद्भव	deva
পুলিশকে	ben_ass
ನಿಯಮಗಳ	kannada
காசு	tamil
ബന്ധപ്പെട്ടു	malayalam
ਵਿਕਰੀ	punjabi
ಸಂಬಂಧದ	kannada
Kingston	latin
ਪੁਸ਼ਟੀ	punjabi
দ্গে	ben_ass
generating	latin
जगाच्या	deva
ઉત્તરાખંડ	gujarati
பயணத்தை	tamil
کلی	arabic
ਸਾਊਥ	punjabi
ಪತ್ರಿಕೆಗಳಲ್ಲಿ	kannada
హైదరాబాదులోనూ	telugu
রহমানকে	ben_ass
ਕਿੱਸੇ	punjabi
நரேந்திர	tamil
બિંદુ	gujarati
સિહોર	gujarati
ಗೋವಿಂದ	kannada
കിഴക്കും	malayalam
ਅਜੀਤ	punjabi
2100	latin
ફિફા	gujarati
கடத்தல்	tamil
अध्ययनों	deva
لبرل	arabic
புனிதர்	tamil
கொள்ளை	tamil
Success	latin
माहितीसाठी	deva
കോർ	malayalam
অভিন্ন	ben_ass
অৰ্থনীতিৰ	ben_ass
సదుపాయాలు	telugu
উপপ্রজাতি	ben_ass
তল	ben_ass
வெளியீடுகள்	tamil
ਕਾਲਪਨਿਕ	punjabi
1989ع	arabic
ಸಂಬಂಧಗಳು	kannada
منصف	arabic
عنه	arabic
సాధన	telugu
ફી	gujarati
মিলনায়তনে	ben_ass
एंट्री	deva
prakria	latin
ಭದ್ರತೆ	kannada
ਸਟੈਂਡਰਡ	punjabi
ਸਵਾਮੀ	punjabi
انا	arabic
సింధు	telugu
बच्चालाई	deva
પ્રથા	gujarati
மென்	tamil
روبنز	arabic
ਨਸਲ	punjabi
વોટર	gujarati
வியாபாரம்	tamil
تنہا	arabic
सीडी	deva
శివాలయం	telugu
১৮৬২	ben_ass
ವಿಂಗಡಿಸಲಾಗಿದೆ	kannada
బ్రహ్మానందం	telugu
રચિત	gujarati
ਵਜ੍ਹਾ	punjabi
1849ء	arabic
വിസ്തൃതിയുള്ള	malayalam
Customs	latin
ڊسٽرڪٽ	arabic
राहण्याची	deva
కోటి	telugu
કાળમાં	gujarati
ಶೋ	kannada
ਲਈਆਂ	punjabi
મિકી	gujarati
വർഷങ്ങളായി	malayalam
deposited	latin
ਜਥੇਦਾਰ	punjabi
ਬਚਣ	punjabi
ڏور	arabic
ھلي	arabic
પાછું	gujarati
ബോര്	malayalam
డిగ్రీల	telugu
धन्य	deva
ਸੰਮੇਲਨ	punjabi
ಅವಲಂಬಿಸಿ	kannada
ವಾಲ್ಟ್	kannada
नदिहरू	deva
દરરોજ	gujarati
ಪರ್ಯಾಯವಾಗಿ	kannada
കാണൂ	malayalam
એટ	gujarati
নির্দেশক	ben_ass
નેટ	gujarati
ਜਦੋਂਕਿ	punjabi
op	latin
చూపిస్తుంది	telugu
मदिरा	deva
గాయకుడు	telugu
સેન	gujarati
sakaa	latin
নেটওয়ার্কের	ben_ass
ગ્રામ્ય	gujarati
ميوزيم	arabic
গায়ে	ben_ass
ನಿರ್ದಿಷ್ಟವಾದ	kannada
ഉൾക്കടൽ	malayalam
کہتی	arabic
போலவும்	tamil
ਅਸਾਮ	punjabi
सकने	deva
ದುರ್ಬಲ	kannada
വീതി	malayalam
વર્તન	gujarati
ಅಗತ್ಯವಿರುವ	kannada
ٹریفک	arabic
વર્ઝન	gujarati
પંજાબી	gujarati
കനാൽ	malayalam
سنڀال	arabic
പ്രിയ	malayalam
પહેલાંના	gujarati
paravarty	latin
पशुवैद्यकीय	deva
ব্যাটসম্যানের	ben_ass
ಸೋಲು	kannada
ఎదురుగా	telugu
ٺاھيو	arabic
வந்தபோது	tamil
આપેલા	gujarati
ਗੁਣਨਫਲ	punjabi
ક્ષેત્રની	gujarati
પ્રદૂષણ	gujarati
हळद	deva
রাখবে	ben_ass
ಸಂರಕ್ಷಣಾ	kannada
kejariwal	latin
جمهوريت	arabic
ಕಲಾತ್ಮಕ	kannada
സുജാത	malayalam
பட்டப்	tamil
شہریت	arabic
பொறி	tamil
जानती	deva
പരമേശ്വരൻ	malayalam
தெலுங்கானா	tamil
احتمال	arabic
جانسن	arabic
ਪ੍ਰਮਾਣੂ	punjabi
ওয়েবসাইটে	ben_ass
ವಿವಾಹವಾದರು	kannada
ਜਰਨਲ	punjabi
absent	latin
भट्टाचार्य	deva
ദക്ഷിണാമൂർത്തി	malayalam
ব্যবস্থাপক	ben_ass
پختہ	arabic
வழங்குகின்றன	tamil
കൂടുതലായും	malayalam
નાગરિકો	gujarati
fakt	latin
हरूको	deva
పేర్కొంది	telugu
ఫుట్	telugu
ਤੁਹਾਡੇ	punjabi
నియోజకవర్గంలో	telugu
পটভূমিতে	ben_ass
விழும்	tamil
कारगर	deva
ನಿಂತ	kannada
দিয়েই	ben_ass
ڀرڳڙي	arabic
ਤਕਨੀਕਾਂ	punjabi
మేలు	telugu
கொள்கின்றன	tamil
কম্বোডিয়া	ben_ass
ಪ್ರೊಫೆಸರ್	kannada
دینار	arabic
ಕೋಲಾರ	kannada
601	latin
preference	latin
നിരോധനം	malayalam
ಅನಂತ	kannada
விலகினார்	tamil
ವೈಶಿಷ್ಟ್ಯ	kannada
ಉತ್ಪಾದನೆಗೆ	kannada
ઈન્ડિયન	gujarati
ಕಲ್ಪನೆಯನ್ನು	kannada
பெரும்பகுதி	tamil
వంతెన	telugu
రూపొందించిన	telugu
ಶಿಕ್ಷೆ	kannada
سما	arabic
ಗುರುವಾರ	kannada
ಆನ್ಲೈನ್	kannada
proceed	latin
ജനങ്ങളിൽ	malayalam
સંતાન	gujarati
ल्याइएको	deva
মারাঠা	ben_ass
केन्द्रं	deva
ഡോൺ	malayalam
آفاق	arabic
وہاڑی	arabic
વધીને	gujarati
પરિવારમાં	gujarati
ਬੈਠੇ	punjabi
ತಂಡಗಳ	kannada
ਚਾਹੇ	punjabi
பீட்டா	tamil
ફ્લેશ	gujarati
ಆದರು	kannada
સમકાલીન	gujarati
महती	deva
सहारनपुर	deva
ഇതിനിടെ	malayalam
bhu	latin
emails	latin
વાવેતર	gujarati
آکسفورڈ	arabic
ತೆಳುವಾದ	kannada
पनवेल	deva
చెక్	telugu
സമ്മർ	malayalam
907	latin
దానితో	telugu
kaaryon	latin
பெ	tamil
زرخیز	arabic
একজনকে	ben_ass
ਥੀਮ	punjabi
ಭಗವಾನ್	kannada
ശുദ്ധജല	malayalam
سحر	arabic
ಹೇಳಿದ್ದಾನೆ	kannada
ವಿಷ್ಣುವಿನ	kannada
குடியுரிமை	tamil
পৌঁছায়	ben_ass
ശുപാർശ	malayalam
आज़कलुक	deva
عیسٲے	arabic
કલોલ	gujarati
comme	latin
સન્માનિત	gujarati
தற்காலிகமாக	tamil
گلے	arabic
খেলনা	ben_ass
పాలనా	telugu
Xavier	latin
இதற்கிடையில்	tamil
كريم	arabic
அறியும்	tamil
ಆಗಿದ್ದಾರೆ	kannada
ਰੁਝਾਨ	punjabi
இராச்சியத்தில்	tamil
கட்டுமானம்	tamil
दळवी	deva
రక్త	telugu
കുറുപ്പ്	malayalam
പുസ്തക	malayalam
ఇరవై	telugu
വഹിച്ചിട്ടുണ്ട്	malayalam
ਸਿਰੇ	punjabi
ప్రవేశ	telugu
উৎকৃষ্ট	ben_ass
সেইদৰে	ben_ass
ಆಟಗಾರರ	kannada
ਦਿੰਦੀਆਂ	punjabi
সর্বকনিষ্ঠ	ben_ass
આયાત	gujarati
وابستگی	arabic
फ्रान्समधील	deva
বাহু	ben_ass
યહૂદી	gujarati
ਮੇਜਰ	punjabi
नद्याः	deva
ஆகவுள்ளனர்	tamil
युरो	deva
ಕಾಶ್ಮೀರದ	kannada
Roberto	latin
pisi	latin
ਅਨੁਸੂਚਿਤ	punjabi
வேண்டுமானாலும்	tamil
कम्तिमा	deva
ਜਲਵਾਯੂ	punjabi
পৰ্যটন	ben_ass
ಸ್ಥಾಪಕ	kannada
insaani	latin
ਮਹਿਮਾਨ	punjabi
البت	arabic
வணங்கி	tamil
certificates	latin
ਵਾਲਾਂ	punjabi
physicist	latin
தைவதம்	tamil
ಪದ್ಧತಿಯಲ್ಲಿ	kannada
கன்னி	tamil
নিউট্রন	ben_ass
आचर्यते	deva
களஞ்சியம்	tamil
दिशि	deva
વઢવાણ	gujarati
Davidson	latin
معرکہ	arabic
ಪೂಜಾ	kannada
અસાધારણ	gujarati
ਫਾਂਸੀ	punjabi
सम्मका	deva
স্থাপত্যের	ben_ass
వర్షపాతం	telugu
শুনি	ben_ass
कार्यलाई	deva
किडनी	deva
વતન	gujarati
స్పష్టం	telugu
চত্বর	ben_ass
তারও	ben_ass
ਯਾਦਗਾਰ	punjabi
trio	latin
દાંત	gujarati
बसों	deva
ভাষ্য	ben_ass
રાત	gujarati
نکتہ	arabic
اہلِ	arabic
૨૦૦૦	gujarati
ਮਾਮਲਾ	punjabi
પ્રોફેસર	gujarati
ಕ್ವೀನ್ಸ್	kannada
फायरिंग	deva
தென்னை	tamil
উঠবে	ben_ass
ಉದ್ದೇಶಿತ	kannada
পরিচালনায়	ben_ass
মাদ্রিদের	ben_ass
1720	latin
परंपराओं	deva
کتنا	arabic
ಜರ್ಮನಿಯಲ್ಲಿ	kannada
విటమిన్	telugu
ফিট	ben_ass
ریور	arabic
ಕವಿತೆ	kannada
ஈரானின்	tamil
pariwesh	latin
अम्मा	deva
सोनाली	deva
بنک	arabic
చెంది	telugu
10వ	telugu
ਹਾਇਕੂ	punjabi
দেখবেন	ben_ass
റു	malayalam
બન્યાં	gujarati
సినిమాల	telugu
ਹਾਲੇ	punjabi
সন্ধানে	ben_ass
రాలేదు	telugu
মুখত	ben_ass
অব্যাহতি	ben_ass
செய்யப்பட	tamil
1911ء	arabic
మధ్యకాలంలో	telugu
ਬੋਧ	punjabi
പരിപാലന	malayalam
ਟਰੱਸਟ	punjabi
ਖ਼ਿਤਾਬ	punjabi
ایڈز	arabic
મંત્ર	gujarati
തള്ളി	malayalam
অ্যাকাউন্ট	ben_ass
പ്രതിനിധി	malayalam
இரண்டுமே	tamil
ಹುಟ್ಟಿದ್ದು	kannada
বর্ষের	ben_ass
paese	latin
বহুলভাৱে	ben_ass
मार्गशीर्ष	deva
Umar	latin
लगाव	deva
himachal	latin
క్లబ్	telugu
പ്രക്ഷോഭം	malayalam
ਦੱਸ	punjabi
تل	arabic
அளவுகளில்	tamil
థియేటర్	telugu
ਕਮਿਊਨਿਟੀ	punjabi
ರೆಕಾರ್ಡ್ಸ್	kannada
ਸਮੀਕਰਨਾਂ	punjabi
ભાગી	gujarati
بتیس	arabic
ಗದಗ	kannada
ਕਦਰਾਂ	punjabi
মুন্সিগঞ্জ	ben_ass
ਕਾਲਜਾਂ	punjabi
ਨਿਆਂ	punjabi
pg	latin
મારો	gujarati
ರಸಾಯನಶಾಸ್ತ್ರ	kannada
بہاولنگر	arabic
வாழ்வை	tamil
তত্ত্বাবধায়ক	ben_ass
નૈતિક	gujarati
টায়	ben_ass
நல்லா	tamil
ڏاڍا	arabic
ஆதாரமாக	tamil
ઓર્ડર	gujarati
விளைவிக்கும்	tamil
ప్రతిభ	telugu
2001ع	arabic
ਉਤਪੰਨ	punjabi
Medindia	latin
তিস্তা	ben_ass
ਨੈੱਟਵਰਕ	punjabi
ਕਿਸ਼ੋਰ	punjabi
அவளுடைய	tamil
ਨਿਰਦੇਸ਼ਤ	punjabi
దారితీసింది	telugu
ఇటు	telugu
ക്ഷേത്രവും	malayalam
italy	latin
बसाई	deva
ആൽബർട്ട്	malayalam
ਅਤੀਤ	punjabi
जुनियर	deva
727	latin
Biodiversity	latin
অদ্যাবধি	ben_ass
द्विधा	deva
जाप	deva
ಕಾರಣವಾಗಬಹುದು	kannada
پراڪرت	arabic
स्क्वायर	deva
அல்லவா	tamil
ರಿಸರ್ವ್	kannada
സ്ഥലത്തു	malayalam
న్యూయార్క్	telugu
లోపలి	telugu
बेलायतको	deva
اعظمی	arabic
ਲੱਭਣ	punjabi
రంగారావు	telugu
ಶಬ್ದವನ್ನು	kannada
पढाइ	deva
Foot	latin
પરીક્ષા	gujarati
ഉത്തർപ്രദേശിലെ	malayalam
മധ്യത്തിൽ	malayalam
ಸಲ್ಲಿಸಿದ್ದಾರೆ	kannada
ചിത്രവും	malayalam
அடையலாம்	tamil
الیاس	arabic
ஒப்பந்தத்தில்	tamil
عظمیٰ	arabic
అవనిగడ్డ	telugu
வழிபட்டு	tamil
தொழிலதிபர்	tamil
किलोमीटरमिते	deva
सघन	deva
తేడా	telugu
ਹੁਨਰ	punjabi
ਸਾਥ	punjabi
Brighton	latin
برادري	arabic
اوراس	arabic
मंगलबार	deva
ਪਹਿਲਵਾਨ	punjabi
સાથેનો	gujarati
ਫ਼ਲਸਫ਼ੇ	punjabi
കായ്കൾ	malayalam
ದೊರೆಯುತ್ತವೆ	kannada
ചെയ്യണം	malayalam
vidhnga	latin
बंड	deva
পরিত্যাগ	ben_ass
ಹೊಂದಾಣಿಕೆ	kannada
શ્વાસ	gujarati
ऊँ	deva
వ్యవసాయావసరాల	telugu
درجن	arabic
സംസ്കാരത്തിന്റെ	malayalam
ಮಂಗಳ	kannada
మ్యూజిక్	telugu
પાકિસ્તાનમાં	gujarati
రకరకాల	telugu
ഗ്രീക്കു	malayalam
മനസ്സ്	malayalam
बु	deva
ਐਕਟਰ	punjabi
શૈલીમાં	gujarati
જોયું	gujarati
बिशप	deva
712	latin
raids	latin
ويڙهه	arabic
തിരു	malayalam
நதியின்	tamil
હકારાત્મક	gujarati
inspiring	latin
లలిత	telugu
एनिमेटेड	deva
ਧਿਰ	punjabi
ਫਾਊਂਡੇਸ਼ਨ	punjabi
مقبوضہ	arabic
લેખકો	gujarati
അക്ഷരം	malayalam
കുട്ടികളും	malayalam
asirier	latin
ഭാഗത്തു	malayalam
मानती	deva
தணிக்கை	tamil
பிழை	tamil
இயல்புகள்	tamil
ಗಮನಾರ್ಹವಾದ	kannada
নাৰীৰ	ben_ass
ਪਰਿਪੇਖ	punjabi
சமயக்	tamil
বদল	ben_ass
ప్రసారం	telugu
શાક	gujarati
ಸೈದ್ಧಾಂತಿಕ	kannada
دائرے	arabic
ઝાડ	gujarati
పిండి	telugu
అతడిని	telugu
செங்கிஸ்	tamil
ਮੇਜ਼ਬਾਨੀ	punjabi
transported	latin
pinne	latin
सरसों	deva
વપરાશકર્તા	gujarati
ਧਾਤ	punjabi
করে৷	ben_ass
ਐਡੀਸ਼ਨ	punjabi
chinn	latin
ಜೋಸ್	kannada
दीर्घिका	deva
ಹೆಚ್ಚಾಗುತ್ತದೆ	kannada
ചന്ദ്രന്റെ	malayalam
بھکر	arabic
గ్రామస్థులు	telugu
ધનસુરા	gujarati
દાદા	gujarati
Marathon	latin
எண்ணிம	tamil
Srinagar	latin
ఇస్తుంది	telugu
گهوڙي	arabic
தனியே	tamil
ਮੈਮੋਰੀਅਲ	punjabi
চীফ	ben_ass
പത്രപ്രവർത്തകർ	malayalam
উপৰত	ben_ass
ধারাবাহিকের	ben_ass
શ્રાવણ	gujarati
ਐਨਰਜੀ	punjabi
શાખાઓ	gujarati
നിയമനം	malayalam
ક્ષેત્રના	gujarati
distinguish	latin
மிளகாய்	tamil
અહેવાલો	gujarati
जीवनकाल	deva
મુશ્કેલી	gujarati
ಮಗುವನ್ನು	kannada
చేయ	telugu
నుంచీ	telugu
கணினியில்	tamil
सामन्यांमध्ये	deva
என்பதைத்	tamil
ആകൃതിയിലുള്ള	malayalam
ఖగోళ	telugu
ਪੀੜਤ	punjabi
ಗ್ರಾಮಾಂತರ	kannada
1935ع	arabic
ਪੈਦਾਵਾਰ	punjabi
ਮਲਿਕ	punjabi
સંકલન	gujarati
આપશે	gujarati
لالچ	arabic
ਸਰਗਰਮੀ	punjabi
गोलीबारी	deva
মুকুল	ben_ass
चुपचाप	deva
ਹੰਗਰੀ	punjabi
கொள்ளப்படுகிறது	tamil
ప్రవేశించి	telugu
വടകര	malayalam
676	latin
சங்கு	tamil
ইনিংসের	ben_ass
apil	latin
সমুহ	ben_ass
કામરેજ	gujarati
വീതിയും	malayalam
విధానాలు	telugu
ಸಂಸ್ಕೃತದಲ್ಲಿ	kannada
சமசுகிருத	tamil
Taipei	latin
கேப்	tamil
ಮೊಹಮ್ಮದ್	kannada
ರುಚಿ	kannada
கட்டடம்	tamil
పెట్టింది	telugu
മേധാവി	malayalam
ప్రాణాలు	telugu
ಗಳಂತಹ	kannada
ಬ್ರಾಹ್ಮಣರು	kannada
മുതലാണ്	malayalam
করাচি	ben_ass
লাভে	ben_ass
வரலாம்	tamil
পরিবেশিত	ben_ass
વાસ્તવમાં	gujarati
aluminium	latin
ਰਾਹੁਲ	punjabi
jarigin	latin
NOAA	latin
খুঁজতে	ben_ass
పంచాయితీ	telugu
ಆರ್ಡರ್	kannada
રૂટ	gujarati
മുതലേ	malayalam
അപ്പർ	malayalam
ദർശനമായി	malayalam
હળવા	gujarati
विनाशकारी	deva
ಧರ್ಮದಲ್ಲಿ	kannada
மொழிகளிலும்	tamil
বেষ্টিত	ben_ass
ದೇವತೆಗಳ	kannada
অভিবাসন	ben_ass
೬೦೦ಮಿಮಿ	kannada
ബംഗ്ലാദേശിലെ	malayalam
Alpinia	latin
પ્રતિષ્ઠા	gujarati
شاهجهان	arabic
ઝેર	gujarati
ಕರೆದುಕೊಂಡು	kannada
પ્રભાવશાળી	gujarati
ਬਚ	punjabi
bihari	latin
પ્રસાદ	gujarati
చంద్రశేఖర్	telugu
ਫੜ	punjabi
ఊరికి	telugu
ಬಾಂಗ್ಲಾದೇಶ	kannada
బ్రిటీషు	telugu
மதிப்பீட்டின்	tamil
बॅडमिंटन	deva
બનતી	gujarati
অ্যালেন	ben_ass
جوڙڻ	arabic
விவகாரம்	tamil
ekadhik	latin
അംഗങ്ങളും	malayalam
عبدالعزیز	arabic
લાઇફ	gujarati
त्याशिवाय	deva
અહી	gujarati
ಯಾರ	kannada
वाहेक	deva
اسٹار	arabic
வாழ்த்து	tamil
നോൺ	malayalam
1689	latin
एलिस	deva
બાંગ્લાદેશ	gujarati
కలిగే	telugu
చేపట్టారు	telugu
ਰਕਬਾ	punjabi
పాలకులు	telugu
Catalan	latin
പറയുകയുണ്ടായി	malayalam
taderke	latin
பட்டுள்ளது	tamil
ಮಧ್ಯಾಹ್ನ	kannada
முற்றுகை	tamil
സൃഷ്ടിക്കുന്നു	malayalam
ਨਾਗਰਿਕਾਂ	punjabi
समानांतर	deva
দাসৰ	ben_ass
पार्टीमा	deva
മെഷീൻ	malayalam
disappear	latin
Discover	latin
ತೆರಳಿದರು	kannada
dodarpak	latin
আশ্রম	ben_ass
Greenwood	latin
ভাসমান	ben_ass
ਰਾਜਧਾਨੀਆਂ	punjabi
analyze	latin
സ്ഥാപിക്കാൻ	malayalam
ಗಿಂತಲೂ	kannada
फर्केर	deva
637	latin
ಕಂಡುಬಂದ	kannada
శాసనాలు	telugu
മരത്തിന്റെ	malayalam
આરંભ	gujarati
Romanized	latin
இலண்டனில்	tamil
اونچی	arabic
मुबारक	deva
स्थितस्य	deva
అరేబియా	telugu
పంతులు	telugu
ಅದೊಂದು	kannada
போட்டித்	tamil
ഉൾപ്പെട്ടിരുന്നു	malayalam
চোৱা	ben_ass
broadcasts	latin
இணைந்தது	tamil
ઇનકાર	gujarati
VIDEO	latin
जुलूस	deva
பாத்திரங்கள்	tamil
సిద్ధం	telugu
പിണ്ഡം	malayalam
pahal	latin
ಮೆಡಿಟರೇನಿಯನ್	kannada
punha	latin
గీతాలు	telugu
દાંતીવાડા	gujarati
સંસદ	gujarati
Nawab	latin
वर्धमानः	deva
सीने	deva
વિસનગર	gujarati
ভাষাকে	ben_ass
16వ	telugu
میامی	arabic
ബ്ലോഗ്	malayalam
દિવસના	gujarati
நடைபெற்றன	tamil
తమిళం	telugu
ਸੰਰਚਨਾ	punjabi
వదిలివేయబడుతోంది	telugu
మగ	telugu
লিপিৰ	ben_ass
ಟ್ರ್ಯಾಕ್	kannada
സഖ്യം	malayalam
ಒಂದೆಡೆ	kannada
بندے	arabic
હૈ૤	gujarati
അബ്ദുള്ള	malayalam
কিল	ben_ass
পাচত	ben_ass
sapa	latin
અનંત	gujarati
இதனுடன்	tamil
अभिनेत्रीको	deva
گناہوں	arabic
हालै	deva
রেজিমেন্টের	ben_ass
நூல்களும்	tamil
அயனிகள்	tamil
lagaakar	latin
ਮੋਟੇ	punjabi
গোলাপী	ben_ass
ബാബുരാജ്	malayalam
ഹിമാചൽ	malayalam
ന്യൂഡല്	malayalam
آنے	arabic
خطرات	arabic
गल्फ	deva
కపూర్	telugu
قاسمی	arabic
ગઢડા	gujarati
ਪਹਿਲ	punjabi
চর্চার	ben_ass
മഹാനായ	malayalam
ഹോളി	malayalam
అక్కడికి	telugu
সুলতানের	ben_ass
SpainBy	latin
ਲਾਰਡ	punjabi
ਚੱਲੀ	punjabi
வாழ்க	tamil
Sacramento	latin
హెడ్	telugu
ഭരണാധികാരി	malayalam
उद्योगपति	deva
پوٽو	arabic
अभिप्रायः	deva
જાપાનમાં	gujarati
উঠিছিল	ben_ass
પ્રતિષ્ઠિત	gujarati
ಕಾಲೇಜುಗಳು	kannada
ഭദ്രകാളി	malayalam
ਲਹਿਰਾਂ	punjabi
ઈશ્વર	gujarati
অনুৰোধ	ben_ass
গার্ডেন	ben_ass
غوری	arabic
ಹುಸೇನ್	kannada
ಒಳಾಂಗಣ	kannada
ಗಳಿಗಿಂತ	kannada
డాలర్లు	telugu
ഹൈസ്കൂളിൽ	malayalam
ਮਾਲੀ	punjabi
ਦਲੀਲ	punjabi
बचना	deva
ಶೈವ	kannada
रुग्ण	deva
சிறுபான்மை	tamil
ஆல்பா	tamil
நீள	tamil
kartrupaksh	latin
ನಾಟಕಗಳಲ್ಲಿ	kannada
ఊరిలో	telugu
എനിക്കു	malayalam
गोडसे	deva
ਜੀਵਾਂ	punjabi
ಬೇಡಿಕೆಯ	kannada
Previously	latin
લોર્ડ	gujarati
అనుభవం	telugu
ಕಾರ್ಯಕ್ರಮಗಳಲ್ಲಿ	kannada
आजारी	deva
പുത്രനായി	malayalam
તેઓના	gujarati
साँखर	deva
ಜನಪ್ರಿಯವಾಗಿದೆ	kannada
কৃষ্ণা	ben_ass
واضع	arabic
కుటుంబాలు	telugu
લાઠી	gujarati
عقیدے	arabic
বাতি	ben_ass
தயாரிக்கலாம்	tamil
જારી	gujarati
चित	deva
বাৰ্তা	ben_ass
pizza	latin
ભળી	gujarati
விளக்குகள்	tamil
ನಿರ್ಧರಿಸಿದರು	kannada
ಕೊರಿಯಾ	kannada
જમીનમાં	gujarati
ஜெயந்தி	tamil
ખાંભા	gujarati
शोषित	deva
ಎರಡನ್ನೂ	kannada
ಮೈದಾನದಲ್ಲಿ	kannada
কমিটিতে	ben_ass
ਫੀਫਾ	punjabi
हुन्न	deva
কিশোরী	ben_ass
తులసి	telugu
காண்டம்	tamil
1939ع	arabic
யுரேனியம்	tamil
కమల్	telugu
ನಡೆಸುತ್ತದೆ	kannada
पश्चिमदिशि	deva
चोक	deva
ਮਸਲੇ	punjabi
બાંધી	gujarati
દરખાસ્ત	gujarati
ਅਨੁਵਾਦਕ	punjabi
இலக்கை	tamil
નિમણૂક	gujarati
fined	latin
ਬੈਡਮਿੰਟਨ	punjabi
ನೋ	kannada
വൻതോതിൽ	malayalam
देशलाई	deva
பிரபாகரன்	tamil
ನವ್ಯ	kannada
মক্কায়	ben_ass
ತುಲನಾತ್ಮಕವಾಗಿ	kannada
સર્પ	gujarati
ಸಮತೋಲನ	kannada
જુદાં	gujarati
સાંભળી	gujarati
ಪಾತ್ರಗಳ	kannada
விவேக்	tamil
நாட்டுக்கு	tamil
વિનાશ	gujarati
نيم	arabic
broader	latin
contestant	latin
Ubuntu	latin
ਹਥਿਆਰਾਂ	punjabi
மக்களவையில்	tamil
ചിത്രങ്ങളിലും	malayalam
ਮੇਅਰ	punjabi
ಸ್ವಾತಂತ್ರ್ಯವನ್ನು	kannada
ورهايل	arabic
जीर्ण	deva
ebn	latin
ਚਲਿਆ	punjabi
Qualification	latin
காதலை	tamil
Rediff	latin
ਮਾਪੇ	punjabi
ஆரம்	tamil
வடகிழக்கில்	tamil
آفيسرن	arabic
खेल्छन्	deva
ਅਤਿਅੰਤ	punjabi
লণ্ডনৰ	ben_ass
ఓడించి	telugu
मनोनीत	deva
জার্সি	ben_ass
இப்படிப்பட்ட	tamil
ৰয়	ben_ass
कुळातील	deva
એકાદશી	gujarati
ھيٺين	arabic
ਤਿੰਨਾਂ	punjabi
জনজাতিৰ	ben_ass
ক্যান্সারের	ben_ass
જામ	gujarati
માસ્ટર	gujarati
यसबाहेक	deva
તૈનાત	gujarati
ಪದರ	kannada
సృష్టి	telugu
એક્સેસ	gujarati
మండలాల	telugu
قوتوں	arabic
ईंट	deva
crookat	latin
மிளகு	tamil
സവിശേഷ	malayalam
yuv	latin
साड़ी	deva
നിരീക്ഷണം	malayalam
பங்கேற்று	tamil
curves	latin
రైళ్ళు	telugu
സീരീസ്	malayalam
ઘરની	gujarati
പ്രവാഹം	malayalam
નિવેદન	gujarati
ನಿಗಮ	kannada
प्रदूषित	deva
syntax	latin
ನಿಷೇಧ	kannada
ਬਾਬਰ	punjabi
టన్నుల	telugu
પર્વતો	gujarati
خورشید	arabic
સપોર્ટ	gujarati
ಮುಂದುವರೆಯಿತು	kannada
آءُ	arabic
duck	latin
ਮਨੀ	punjabi
સ્થાનીય	gujarati
ഭാഷകളിലേക്ക്	malayalam
ਕੁਮਾਰੀ	punjabi
ஏற்றவாறு	tamil
മനുഷ്യരെ	malayalam
ప్రదానం	telugu
గట్టి	telugu
Bukhari	latin
ਵੇਚਣ	punjabi
ലേ	malayalam
ഗുഹകൾ	malayalam
கீழுள்ள	tamil
ਚੁੱਕ	punjabi
నున్న	telugu
இவரால்	tamil
രഹസ്യമായി	malayalam
مخلص	arabic
అక్బర్	telugu
ಕ್ಯಾಲಿಫೋರ್ನಿಯಾದ	kannada
വസിക്കുന്നു	malayalam
એટલાન્ટા	gujarati
கோழிக்கோடு	tamil
ఆమదాలవలస	telugu
ਰਾਮਦਾਸ	punjabi
അഭ്യസിച്ചു	malayalam
ittar	latin
இருக்கக்கூடும்	tamil
അർദ്ധ	malayalam
೦೦	kannada
جڑی	arabic
ഇന്ത്യക്ക്	malayalam
آبادیات	arabic
teaspoon	latin
ஊடகங்களில்	tamil
ഇനമാണ്	malayalam
పద్మ	telugu
ഫേസ്	malayalam
অন্যান্যদের	ben_ass
مجیب	arabic
ഇതുമൂലം	malayalam
ചെന്നൈയിലെ	malayalam
నామకరణం	telugu
ನಿಯಮಿತವಾಗಿ	kannada
சங்கங்கள்	tamil
aagaaz	latin
ತಳಿಗಳು	kannada
باتھ	arabic
ಘಟನೆಗಳ	kannada
ಈಶ್ವರ	kannada
ஆரம்பித்த	tamil
ਵਣਜਾਰਾ	punjabi
ڪمانڊر	arabic
ਬਰਫ਼	punjabi
பெல்ஜியம்	tamil
టర్కీ	telugu
കളർ	malayalam
semester	latin
टेलिविज़न	deva
પરિણમે	gujarati
கருதினார்	tamil
కర్ణుడు	telugu
gopal	latin
709	latin
ವಿಶ್ವದಲ್ಲೇ	kannada
નિરૂપણ	gujarati
യാത്രയിൽ	malayalam
पैगंबर	deva
মোকাবিলা	ben_ass
opener	latin
ಪ್ರಮುಖರು	kannada
পুল	ben_ass
കൊല്ലവർഷം	malayalam
শিকারী	ben_ass
पॆठ	deva
ਪ੍ਰਤੀਤ	punjabi
ઉમેદવાર	gujarati
இறுதிக்	tamil
Yuan	latin
వేళ	telugu
ಆಡಳಿತದಲ್ಲಿ	kannada
சென்னையிலிருந்து	tamil
स्ट्राइकर	deva
లోకసభ	telugu
چوٽي	arabic
रिकॉर्ड्स	deva
ಸದಸ್ಯರಾಗಿದ್ದರು	kannada
গর্ত	ben_ass
இடமாகும்	tamil
പുത്തൻ	malayalam
நாகேஷ்	tamil
दुर्गः	deva
મિશન	gujarati
madhyei	latin
ஆகிறது	tamil
जादा	deva
1906ء	arabic
ਬਹੁਤੀ	punjabi
કાર્યક્રમમાં	gujarati
1927ع	arabic
ਚੁੱਕੀਆਂ	punjabi
பிரிவுகளைக்	tamil
ബിസി	malayalam
رھندو	arabic
నెల్లూరులో	telugu
മറ്റെല്ലാ	malayalam
ইহঁতক	ben_ass
ಗಮನಕ್ಕೆ	kannada
ছপা	ben_ass
১০৫	ben_ass
తెలుపు	telugu
അലങ്കാര	malayalam
ಸಂಗಮ	kannada
सेन्ट्रल	deva
ఒకడు	telugu
సునీల్	telugu
പ്രസിഡന്റും	malayalam
તીર્થંકર	gujarati
ਟਿੱਪਣੀ	punjabi
హైడ్రోజన్	telugu
तिथून	deva
ਪੋਲਿਸ਼	punjabi
ਖਪਤ	punjabi
ಪ್ರಯೋಗಗಳು	kannada
ਕਾਉਂਟੀ	punjabi
पदभार	deva
ഗ്രന്ഥത്തിന്റെ	malayalam
அள்ளி	tamil
రాజ్యంలో	telugu
സാമ്രാജ്യത്തിലെ	malayalam
वक़्त	deva
कॅरिबियन	deva
அடர்	tamil
பிரச்சினைகளை	tamil
೧೯೭೬	kannada
ಸ್ನೇಹಿತ	kannada
१८३०	deva
పద్ధతులు	telugu
पुस्तकातील	deva
அதனைப்	tamil
Lights	latin
അറ്റത്ത്	malayalam
மேற்கூறிய	tamil
ముఖ్యమైనవి	telugu
અમને	gujarati
শোভা	ben_ass
নিজেদেরকে	ben_ass
வளர்ந்தது	tamil
ਹਜ਼ਰਤ	punjabi
பயிலும்	tamil
భారీగా	telugu
ഓക്സൈഡ്	malayalam
کشف	arabic
ನಾಯಿ	kannada
എയ്	malayalam
நரம்பியல்	tamil
kuiandaikas	latin
विकाश	deva
ಕಾರ್ಯಕಾರಿ	kannada
ਪ੍ਰਵਾਨ	punjabi
अध्ययनको	deva
আইল্যান্ড	ben_ass
ನೀಡುವಂತೆ	kannada
ਸਹਾਰਾ	punjabi
मनुष्यस्य	deva
પિતાનું	gujarati
குடும்பப்	tamil
കിയത്	malayalam
சாப்பிட	tamil
ಗಣಿ	kannada
മത്തായി	malayalam
ఆడ	telugu
తెచ్చి	telugu
फ़्रांस	deva
ਘਿਰਿਆ	punjabi
নিত্য	ben_ass
ധാരണ	malayalam
طاقتوں	arabic
इज्जत	deva
ગ્રાહકોને	gujarati
വർഷത്തിനു	malayalam
लागवडीला	deva
स्वतःचा	deva
નરમ	gujarati
முயற்சியால்	tamil
প্রথমেই	ben_ass
তালা	ben_ass
ಲೀಡ್ಸ್	kannada
ఆధిపత్యం	telugu
سودا	arabic
13வது	tamil
മഹൽ	malayalam
ശക്തിയായി	malayalam
खुप	deva
લોકશાહી	gujarati
વાગરા	gujarati
उचाइ	deva
প্রদর্শনীর	ben_ass
ਫ਼ਰਕ	punjabi
ഇരുപത്	malayalam
உடைத்து	tamil
بودھ	arabic
ચીફ	gujarati
கலாம்	tamil
صابر	arabic
శ్రీనివాస	telugu
నగరంలోని	telugu
গ্যারি	ben_ass
بنيادن	arabic
সুন্দরবনের	ben_ass
સીટી	gujarati
೪೦೦	kannada
ఛైర్మన్	telugu
خانم	arabic
గోధుమ	telugu
భద్రాద్రి	telugu
গির্জার	ben_ass
السّلام	arabic
ಪರೀಕ್ಷೆಯನ್ನು	kannada
ટૂર	gujarati
ടാഗോർ	malayalam
సంస్థలో	telugu
شنکر	arabic
సంవత్సరాలుగా	telugu
nikaala	latin
टिममा	deva
చిత్రాలను	telugu
پھینک	arabic
খেলায়	ben_ass
ਲਾਈਵ	punjabi
పక్క	telugu
அசோக்	tamil
રાખ્યા	gujarati
ಆಳ್ವಿಕೆಯಲ್ಲಿ	kannada
வெளியிடப்படும்	tamil
પુરૂષ	gujarati
દ્વીપ	gujarati
వ్యవహరిస్తారు	telugu
পর্দার	ben_ass
പാർവതി	malayalam
Laser	latin
ഡാർവിൻ	malayalam
ਚਿੱਤਰਾਂ	punjabi
೩೩	kannada
Chicken	latin
ফণী	ben_ass
பெருங்கடலில்	tamil
پوشیدہ	arabic
ಅಲ್ಲೇ	kannada
നിലകളിലും	malayalam
బండి	telugu
இருக்கையில்	tamil
kanan	latin
enjoyable	latin
ਲੋਕਗੀਤ	punjabi
ਸ਼ਾਂਤ	punjabi
പ്രതിഭാസം	malayalam
نسخے	arabic
incorporating	latin
ਦੁਰਗਾ	punjabi
അടിസ്ഥാനത്തിലാണ്	malayalam
ಅನಿಲದ	kannada
அகன்ற	tamil
চাকুরী	ben_ass
കാലിക്കറ്റ്	malayalam
૧૯૭૩	gujarati
ಸಕಾರಾತ್ಮಕ	kannada
പ്രസ്സ്	malayalam
૧૯૭૭	gujarati
hamro	latin
પેપર	gujarati
آدمیوں	arabic
ওয়ার্নার	ben_ass
നിലവില്	malayalam
ವ್ಯಾಪಾರಿಗಳು	kannada
Saheb	latin
नदीची	deva
نان	arabic
ਸਮਗਰੀ	punjabi
গুহ	ben_ass
போராளிகள்	tamil
சைமன்	tamil
നാഥ്	malayalam
ભાષાનો	gujarati
ਉਹਦੀ	punjabi
ஒருவரும்	tamil
இதைச்	tamil
Aditya	latin
પોર્ટુગીઝ	gujarati
ವಹಿಸಿದ್ದರು	kannada
BSNL	latin
അസ്	malayalam
అల్లుడు	telugu
ದುಬೈ	kannada
emergence	latin
மாற்றப்பட்டு	tamil
அன்	tamil
વાગ્યે	gujarati
எரிக்	tamil
ھا	arabic
Courts	latin
Halt	latin
૧૯૮૨	gujarati
collided	latin
Lionel	latin
ಉದ್ದೇಶಗಳಿಗಾಗಿ	kannada
مرتفع	arabic
ਅਹਿਮਦਾਬਾਦ	punjabi
লামার	ben_ass
ਹਾਜ਼ਰੀ	punjabi
পর্তুগালের	ben_ass
ਉਪਨਾਮ	punjabi
ہالٹ	arabic
மாவட்டத்	tamil
wandering	latin
Patent	latin
பன்னிரு	tamil
സ്മിത്ത്	malayalam
నేపాల్	telugu
આંકડાઓ	gujarati
வெளியிட்டுள்ள	tamil
ਬਹਾਦੁਰ	punjabi
തിരൂർ	malayalam
ಏನಾದರೂ	kannada
ఆంధ్రా	telugu
നിർവ്വഹിച്ച	malayalam
ಕಂದಾಯ	kannada
ਪਤਨ	punjabi
पालि	deva
rajkiya	latin
ટુર્નામેન્ટ	gujarati
ਰੰਧਾਵਾ	punjabi
शन	deva
ಸೈನಿಕರ	kannada
ಪ್ರತಿನಿಧಿಗಳು	kannada
എന്നതു	malayalam
ಸಂಗ್ರಹಿಸಿದ	kannada
निर्मितानि	deva
দুয়োখন	ben_ass
पाहुणे	deva
கதைகளில்	tamil
منعقدہ	arabic
உழைப்பு	tamil
দপ্তরের	ben_ass
સૈનિક	gujarati
শৈশবে	ben_ass
adityanath	latin
tigers	latin
उपजाऊ	deva
gayo	latin
karagar	latin
انفارمیشن	arabic
ಮಾತನಾಡಿ	kannada
ಜಿಲ್ಲೆಗಳ	kannada
भाऊसाहेब	deva
ವೀಡಿಯೊ	kannada
वायुयान	deva
ઉત્કૃષ્ટ	gujarati
మానవులు	telugu
૧૯૬૯	gujarati
ಪಾಲನ್ನು	kannada
ఇండోర్	telugu
நகரத்திலிருந்து	tamil
ਅੰਦਾਜ਼ਾ	punjabi
வித்தியாசம்	tamil
explicitly	latin
چائنا	arabic
ನ್ಯಾಯಾಂಗ	kannada
ਪ੍ਰੀਸ਼ਦ	punjabi
குழந்தைகளில்	tamil
പടിഞ്ഞാറായി	malayalam
tannai	latin
भूमिकेसाठी	deva
ഇര	malayalam
క్రీడాకారుడు	telugu
घुसपैठ	deva
తి	telugu
ആളുകൾക്ക്	malayalam
ਮਾਰਕਸਵਾਦ	punjabi
सूरी	deva
கலாசார	tamil
ਕੰਧਾਂ	punjabi
ముఖం	telugu
વધ	gujarati
ਮਗਰ	punjabi
નિકાલ	gujarati
வளிமண்டலத்தில்	tamil
ವ್ಯಾಟ್ಸನ್	kannada
முதலாவதாக	tamil
ఆక్సైడ్	telugu
ਕਮਾਲ	punjabi
वर्तन	deva
ਤਾਲ	punjabi
வடமேற்கில்	tamil
വിഷ്വൽ	malayalam
আলাদাভাবে	ben_ass
చెక్క	telugu
नेपालदेशस्य	deva
ڦٽي	arabic
கொடுக்கப்பட்டது	tamil
वृक्षस्य	deva
ಕರೆಯಲಾಯಿತು	kannada
উৎসের	ben_ass
പന്ത്രണ്ടു	malayalam
బిగ్	telugu
ಯಾ	kannada
ਰਾਜੀਵ	punjabi
ਸੈਨਿਕ	punjabi
வியாழன்	tamil
thorough	latin
वेदको	deva
Sword	latin
ਐੱਲ	punjabi
ਜੱਟਾਂ	punjabi
ਵੱਜੋਂ	punjabi
ਪੰਚਾਇਤ	punjabi
വിശ്വനാഥൻ	malayalam
844	latin
ভূখণ্ড	ben_ass
پہل	arabic
కిమీ	telugu
ورتا	arabic
ಇಷ್ಟ	kannada
மதிப்பில்	tamil
कंगना	deva
ਬਰਕਰਾਰ	punjabi
વિદેશમાં	gujarati
সন্দ্বীপ	ben_ass
പ്രാപിച്ചു	malayalam
ಸಿದ್ಧಾಂತಗಳು	kannada
പ്പെടെ	malayalam
ఉపయోగించారు	telugu
ತೃತೀಯ	kannada
ਫ਼ਾਰ	punjabi
ಸಕ್ರಿಯವಾಗಿ	kannada
நிகர	tamil
കഴിയാതെ	malayalam
માંગતા	gujarati
ఒకరి	telugu
ಅಭಿನಯಿಸಿದ	kannada
పసిఫిక్	telugu
مامور	arabic
بلین	arabic
preceded	latin
१७९९	deva
ஒடுக்க	tamil
adhikamak	latin
ফরিদ	ben_ass
કચરો	gujarati
ஆட்ட	tamil
விவரங்களை	tamil
కర్మ	telugu
गणिती	deva
wrap	latin
கேமரா	tamil
ज़िंदगी	deva
முயற்சிகளை	tamil
نم	arabic
ವಾಹಕ	kannada
ਅਰਸੇ	punjabi
vivechana	latin
प्रबोधिनी	deva
શિયાળામાં	gujarati
નડાલ	gujarati
കാരണത്താൽ	malayalam
सल्फर	deva
ٻيڙين	arabic
حسنی	arabic
છાપ	gujarati
Arlington	latin
తీర	telugu
શક્યો	gujarati
ड्रॉ	deva
ਕਮਾਂਡਰ	punjabi
மெகா	tamil
હરિયાણા	gujarati
ಉಣ್ಣೆ	kannada
மாங்கனீசு	tamil
2009లో	telugu
मार्गमा	deva
বিপ্লৱৰ	ben_ass
ਇਉਂ	punjabi
സന്ദർശിച്ച	malayalam
ఏర్పడి	telugu
புலனாய்வு	tamil
ದೋಷ	kannada
ਜੀਵਤ	punjabi
প্রস্তর	ben_ass
ਲਿਮਟਿਡ	punjabi
ஊற்றி	tamil
ക്കൊപ്പം	malayalam
બનાવવાનો	gujarati
ఆదిలాబాదు	telugu
യുവജന	malayalam
মৰা	ben_ass
દસ્તાવેજી	gujarati
چنیوٹ	arabic
Heavyweight	latin
వ్యయంతో	telugu
pills	latin
കർണാടകയിലെ	malayalam
ತಯಾರಿಕೆಯ	kannada
ಆಮ್ಲದ	kannada
പ്രമുഖനായ	malayalam
வைத்திருந்தார்	tamil
backdrop	latin
आईएएस	deva
దేశపు	telugu
પ્રોત્સાહિત	gujarati
വരാം	malayalam
చిత్రాలకు	telugu
معاش	arabic
നിമിഷം	malayalam
वेदांग	deva
ٻير	arabic
సౌదీ	telugu
തീരുമാനിച്ചത്	malayalam
சைக்கிள்	tamil
মান্না	ben_ass
ਐਲਨ	punjabi
ஒழிப்பு	tamil
ভাষাটি	ben_ass
மாறிலி	tamil
چاهيو	arabic
నెం	telugu
987	latin
প্ৰশাসন	ben_ass
மற்றுமொரு	tamil
હકીકત	gujarati
బ్రెజిల్	telugu
टंक	deva
రైతుల	telugu
അപൂർവ്വമായി	malayalam
aria	latin
തടഞ്ഞു	malayalam
ಜೀವಶಾಸ್ತ್ರ	kannada
ਘੇਰੇ	punjabi
ਲਾਲਾ	punjabi
വിദൂര	malayalam
বাজি	ben_ass
લીલો	gujarati
সন্ধ্যায়	ben_ass
ప్రేక్షకుల	telugu
સિવિલ	gujarati
ਪਿਆਰੇ	punjabi
കെട്ടിടത്തിന്റെ	malayalam
Vintage	latin
मार्क्सवाद	deva
spiral	latin
দারিদ্র্য	ben_ass
దానిలో	telugu
দিবাগত	ben_ass
ડાઉનલોડ	gujarati
నెల్లూరులోనూ	telugu
پڑھیے	arabic
വച്ച	malayalam
பழனிசாமி	tamil
باقاعده	arabic
مترادف	arabic
జమ్మూ	telugu
सिमसार	deva
ಖಚಿತ	kannada
ശശികുമാർ	malayalam
நார்வே	tamil
ڪلڪتي	arabic
ಕೋಚ್	kannada
ਛਾਪਿਆ	punjabi
சாப்பிட்டு	tamil
న్యాయవాది	telugu
கடின	tamil
جذباتی	arabic
ওচৰ	ben_ass
ಫುಲ್	kannada
لکيون	arabic
ਸਾਫ	punjabi
ਸੁੱਟ	punjabi
ஏற்படக்கூடிய	tamil
جاگیر	arabic
வசதியாக	tamil
అవార్డును	telugu
લેશે	gujarati
മിശ്രിതം	malayalam
ರೇಖೆ	kannada
mukaamat	latin
સેનાએ	gujarati
ব্রাদার্স	ben_ass
ਉਪਯੋਗ	punjabi
മിസ്റ്റർ	malayalam
ਐਤਵਾਰ	punjabi
accountability	latin
ఆకాశవాణి	telugu
వచ్చినా	telugu
తీరు	telugu
ਅਖਾਣ	punjabi
بھتر	arabic
ಗಳಿಸಿದ್ದಾರೆ	kannada
నరేంద్ర	telugu
ఒకరోజు	telugu
ശസ്ത്രക്രിയ	malayalam
మదనపల్లె	telugu
দূতাবাসের	ben_ass
ਬੇ	punjabi
কমপ্লেক্সে	ben_ass
કોર્ટમાં	gujarati
മാസത്തിലെ	malayalam
వ్యాపారాత్మక	telugu
अभ्यंकर	deva
ৰ্ড	ben_ass
ਤਾਰੀਖ	punjabi
ക്ഷേത്രങ്ങളും	malayalam
তেমনই	ben_ass
ആഘോഷം	malayalam
ਅਥਲੀਟ	punjabi
সিদ্দিক	ben_ass
ബാല്യം	malayalam
खांसी	deva
गर्थ्यो	deva
കൊടുക്കുകയും	malayalam
1725	latin
आइटम	deva
உலகை	tamil
രൂപത്തിലാണ്	malayalam
પોષણ	gujarati
ਤਦ	punjabi
ત્રણેય	gujarati
اوچو	arabic
ਪਟੇਲ	punjabi
ਦਰਿਆਵਾਂ	punjabi
policeulu	latin
ಹೇಳಿತು	kannada
ਤਾਰਾਮੰਡਲ	punjabi
ਤਹਿ	punjabi
சதுப்பு	tamil
تھوڑے	arabic
સ્ટેટ્સના	gujarati
মেয়েকে	ben_ass
ਸਾਖੀ	punjabi
पहाडमा	deva
ਉਚਾਰਨ	punjabi
આંખો	gujarati
પક્ષો	gujarati
ഊർജ്ജ	malayalam
रावसाहेब	deva
साध्वी	deva
چيل	arabic
રસાયણ	gujarati
ಬಿಎನ್	kannada
ধনেশ	ben_ass
અદ્યતન	gujarati
गिफ्ट	deva
কলার	ben_ass
ਇੰਟਰਨੈਟ	punjabi
ಬಚ್ಚನ್	kannada
వైట్	telugu
எதிரி	tamil
કર્મ	gujarati
ઓસ્ટ્રેલિયામાં	gujarati
आजपर्यंत	deva
ജമാഅത്തെ	malayalam
irukku	latin
ಪ್ರಾಧ್ಯಾಪಕರಾಗಿ	kannada
838	latin
وکلا	arabic
అంకితం	telugu
ਮਹਾਂਕਾਵਿ	punjabi
நுண்ணறிவு	tamil
లేకపోతే	telugu
શાળાના	gujarati
Dept	latin
irunnu	latin
ਮੁੱਲਾਂ	punjabi
Telecommunications	latin
૧૯૯૮	gujarati
ਬੂਟੇ	punjabi
மெய்நிகர்	tamil
అన్నం	telugu
कहेंगे	deva
ದೊರೆತಿವೆ	kannada
ગૌરવ	gujarati
మరియూ	telugu
ڀنڀور	arabic
देशाला	deva
రుచి	telugu
பயன்பட்டது	tamil
ഓർ	malayalam
ਵਿੱਚੋ	punjabi
فائديمند	arabic
stabbed	latin
ರೂಪಿಸಲು	kannada
জুলিয়ান	ben_ass
सर्वम्	deva
తరహా	telugu
கம்பி	tamil
అన్నమయ్య	telugu
એડવર્ડ	gujarati
aghat	latin
વિકસાવી	gujarati
చేయుటకు	telugu
दिखायी	deva
ಲಾವಣಿ	kannada
નિષ્ફળતા	gujarati
ಪ್ರಕ್ರಿಯೆಗೆ	kannada
لئنگئيج	arabic
ਪਲੇਟ	punjabi
પ્લેટફોર્મ	gujarati
വ്യാജ	malayalam
جرات	arabic
MiG	latin
ಸ್ಫೂರ್ತಿ	kannada
ಗ್ರಂಥಗಳಲ್ಲಿ	kannada
పామర్రు	telugu
ఆసుపత్రిలో	telugu
শন	ben_ass
सायं	deva
வந்தவாசி	tamil
പ്രോട്ടോക്കോൾ	malayalam
അടുത്തിടെ	malayalam
లాస్	telugu
ಭಾಗಗಳಿಗೆ	kannada
బదులు	telugu
மோசமாக	tamil
Forecasts	latin
ਅੱਲ੍ਹਾ	punjabi
गोरखनाथ	deva
વિશ્વનો	gujarati
शिफारस	deva
રૂમ	gujarati
ധനസഹായം	malayalam
૧૯૯૯	gujarati
మొదలగునవి	telugu
வழியாகச்	tamil
ವಿಗ್ರಹ	kannada
ಪ್ರವಾಹದ	kannada
നൽകും	malayalam
ক্যাশ	ben_ass
வானூர்திகள்	tamil
ಚೈತನ್ಯ	kannada
રૂપાંતર	gujarati
ಚಲನಚಿತ್ರವನ್ನು	kannada
பெயர்களும்	tamil
ಶರಣ	kannada
723	latin
રાજ્યનાં	gujarati
எனுமிடத்தில்	tamil
مطلوبہ	arabic
அடுத்துள்ள	tamil
పదవిని	telugu
স্বত্ত্বেও	ben_ass
যশ	ben_ass
ਮੁਸ਼ਕਿਲ	punjabi
ਗੋਲੀਆਂ	punjabi
ಸಾಧನೆಯನ್ನು	kannada
shunya	latin
चकित	deva
పక్షి	telugu
સંજોગોમાં	gujarati
ڪوئيٽا	arabic
मणी	deva
તેટલી	gujarati
ਈਅਰ	punjabi
मराठ्यांनी	deva
മതിയായ	malayalam
লেবেল	ben_ass
ഇന്റര്	malayalam
નકશા	gujarati
پولش	arabic
గ్రామాలకు	telugu
தற்சமயம்	tamil
ਖਣਿਜ	punjabi
ٽيلي	arabic
বিতাড়িত	ben_ass
സംഗീതജ്ഞർ	malayalam
வணிகவியல்	tamil
இவருடன்	tamil
મીઠા	gujarati
স্মৃতিসৌধ	ben_ass
ತೋರಿಸಲು	kannada
ಹೊಂದಿದ್ದರೂ	kannada
بیور	arabic
مٽاسٽا	arabic
ਪ੍ਰੇਰਣਾ	punjabi
تلقین	arabic
திட்டமிட்ட	tamil
altogether	latin
ದಾಖಲೆಗಳ	kannada
টিউব	ben_ass
അഭാവം	malayalam
cured	latin
கண்டறிதல்	tamil
aavya	latin
শপিং	ben_ass
உள்ளடக்கியுள்ளது	tamil
गोलो	deva
പൂനെ	malayalam
بھیڑ	arabic
పోలి	telugu
મહત્ત્વના	gujarati
வருகிற	tamil
അഭിമുഖം	malayalam
सर्ने	deva
jova	latin
944	latin
સિદ્ધિ	gujarati
ಪ್ರಾಬಲ್ಯ	kannada
त्वम्	deva
स्कूलमा	deva
വാഷിങ്ടൺ	malayalam
ਆਮਤੌਰ	punjabi
ਪਹਿਲੂਆਂ	punjabi
అమ్మా	telugu
ಸಂಶೋಧನೆಯು	kannada
शुद्धीकरण	deva
૧૯૭૮	gujarati
উইল	ben_ass
ஆயிரத்து	tamil
വിനീത്	malayalam
નાખે	gujarati
ਸੁਪਨੇ	punjabi
பொதுமக்களின்	tamil
PK	latin
ಬದುಕನ್ನು	kannada
ముఖర్జీ	telugu
ஆண்டிற்கு	tamil
வேளாளர்	tamil
భావం	telugu
રોગના	gujarati
ਸੱਸੀ	punjabi
कथम्	deva
युगांडा	deva
ইয়র্কশায়ার	ben_ass
ಕ್ರಿಯೆಗೆ	kannada
చుట్టుపక్కల	telugu
எதை	tamil
ਦੱਸਣ	punjabi
ਨਿਕਲਿਆ	punjabi
ভাইরাসের	ben_ass
سنئون	arabic
ਨਿਯਮਤ	punjabi
واسطہ	arabic
খেলোয়াড়	ben_ass
சுதேச	tamil
ಸ್ವಾಭಾವಿಕವಾಗಿ	kannada
പട്ടേൽ	malayalam
پھیلے	arabic
മലയാളചലച്ചിത്ര	malayalam
ধৰ্ষণ	ben_ass
বৌদ্ধধর্ম	ben_ass
দ্রুতগামী	ben_ass
హామీ	telugu
புறத்தில்	tamil
বছরেই	ben_ass
സോളാർ	malayalam
ڪارل	arabic
സ്ഥാനത്താണ്	malayalam
آء	arabic
আঠ	ben_ass
કોલ	gujarati
கொடுப்பது	tamil
സെർച്ച്	malayalam
৫ই	ben_ass
رطوبت	arabic
முற்றாக	tamil
మరుగుదొడ్ల	telugu
عليءَ	arabic
DS	latin
ಹೊಂದಿರುವುದು	kannada
ہماچل	arabic
এফএ	ben_ass
વાલ	gujarati
தரப்படும்	tamil
பாதுகாப்பை	tamil
Raza	latin
પ્રાચિન	gujarati
நீங்களும்	tamil
ప్రాధాన్యతా	telugu
অমূল্য	ben_ass
yantra	latin
அகம்	tamil
क्यालिफोर्निया	deva
పిక్చర్స్	telugu
జార్జ్	telugu
સ્વચ્છ	gujarati
तहरीर	deva
Floyd	latin
திப்பு	tamil
മാവ്	malayalam
ਖੂਬਸੂਰਤ	punjabi
ਔਸਤਨ	punjabi
ಸ್ನೇಹಿತರು	kannada
వాడుక	telugu
affiliates	latin
ਪੰਜਵੇਂ	punjabi
கிடைத்துள்ளன	tamil
ಒಳಗಡೆ	kannada
সন্নিবিষ্ট	ben_ass
নিঃসন্দেহে	ben_ass
ಆನುವಂಶಿಕ	kannada
উড্ডয়ন	ben_ass
ದಂತ	kannada
শ্রীলঙ্কায়	ben_ass
கொண்டுவந்து	tamil
మీడియాలో	telugu
ప్రమాదంలో	telugu
ڪريون	arabic
ਬਤੀਤ	punjabi
ਮਾਡਲਿੰਗ	punjabi
ശബ്ദ	malayalam
ক্যারিবীয়	ben_ass
ஒலிப்பதிவு	tamil
ಪರ್ವತಗಳು	kannada
گاجي	arabic
Leopard	latin
કાયમ	gujarati
કોઈને	gujarati
ചൗധരി	malayalam
பிரார்த்தனை	tamil
പരമ്പരാഗതമായ	malayalam
ਥੋੜਾ	punjabi
ਸ਼ਾਨ	punjabi
ریت	arabic
additions	latin
پروٹسٹنٹ	arabic
కొల్లూరి	telugu
ദേശാടനം	malayalam
নিদৰ্শন	ben_ass
जिलानुसार	deva
तानाशाही	deva
ತರಲಾಯಿತು	kannada
குரூப்	tamil
Colour	latin
તર્ક	gujarati
पोटात	deva
ਮਹਾਰਾਜ	punjabi
ಪ್ರಯೋಜನ	kannada
രാജവംശത്തിലെ	malayalam
আহমদের	ben_ass
લોકસભા	gujarati
سارو	arabic
তরফ	ben_ass
నివృత్తి	telugu
ടൈഗർ	malayalam
ಗ್ಲೋಬ್	kannada
ಕನ್ನಡಿಗರು	kannada
પ્રજનન	gujarati
9వ	telugu
পিতামাতার	ben_ass
ਸਾਂਭ	punjabi
ಕಾರಿನ	kannada
অনেকদিন	ben_ass
రాయి	telugu
gardee	latin
कार्यलय	deva
ಮನುಷ್ಯರ	kannada
پڇڙ	arabic
స్పెషల్	telugu
செருமனியின்	tamil
انڈمان	arabic
ਸੰਗਰਾਮ	punjabi
decree	latin
गावच्या	deva
Coins	latin
చేరుకున్నారు	telugu
sarvashesh	latin
ಯಂತ್ರಗಳನ್ನು	kannada
బాస్	telugu
രാജാവും	malayalam
खोलामा	deva
ਪ੍ਰਵਾਸੀ	punjabi
بہبود	arabic
ഇനത്തിൽ	malayalam
தக்காளி	tamil
ਜਦੋ	punjabi
প্লাজমা	ben_ass
राष्ट्रगीत	deva
పాక్	telugu
ஆடைகள்	tamil
ਆਨਰੇਰੀ	punjabi
ਪਰੀ	punjabi
predictions	latin
ਪੱਤਿਆਂ	punjabi
ఆకారంలో	telugu
इंग्लंडचे	deva
ശ്രീകൃഷ്ണ	malayalam
જામજોધપુર	gujarati
ಪರೀಕ್ಷೆಗಳನ್ನು	kannada
storms	latin
പോവുകയും	malayalam
ಗ್ಲಾಸ್	kannada
బీచ్	telugu
ಒಂದಾಗಿ	kannada
Mercy	latin
راستوں	arabic
ਪੁੱਛਿਆ	punjabi
ಲಭಿಸಿದೆ	kannada
ശരിക്കും	malayalam
منقول	arabic
ರಾಬರ್ಟ್ಸ್	kannada
अनोखी	deva
یکجا	arabic
கடத்தி	tamil
ಉದ್ಯಮಗಳು	kannada
ਘੋੜਾ	punjabi
বারী	ben_ass
ಅದರೆ	kannada
చేసినట్లు	telugu
గారికి	telugu
సాయిబాబా	telugu
२७०	deva
একসময়	ben_ass
పడమర	telugu
സാഹിത്യത്തിനുള്ള	malayalam
மாற்றியது	tamil
ಕರಡಿ	kannada
نقوش	arabic
তি	ben_ass
నారా	telugu
കിം	malayalam
ವಿರಳವಾಗಿ	kannada
വ്യാഴത്തിന്റെ	malayalam
હૈં	gujarati
আৱৰি	ben_ass
ಪಾಲಿಟೆಕ್ನಿಕ್	kannada
ભક્ત	gujarati
શરીરને	gujarati
ವಿಚ್	kannada
పెనమలూరు	telugu
ಮಾಡದೆ	kannada
uniforms	latin
বিস্তীর্ণ	ben_ass
ماننا	arabic
అంశంపై	telugu
గంగ	telugu
திருச்சூர்	tamil
Homo	latin
عمرہ	arabic
ફિલ્મને	gujarati
Daddy	latin
আদায়ের	ben_ass
বৃদ্ধিতে	ben_ass
ਕੋਣ	punjabi
നാലോ	malayalam
ಔದ್ಯೋಗಿಕ	kannada
અનુભવી	gujarati
యితర	telugu
ഡാനിഷ്	malayalam
महाराजांना	deva
മരണത്തിന്	malayalam
മൂന്നായി	malayalam
ਕਾਢ	punjabi
ಯುವಕ	kannada
ചെറുകഥ	malayalam
வல்லுநர்கள்	tamil
دالہ	arabic
ਪੇਸ਼ੇ	punjabi
সমাজবিজ্ঞান	ben_ass
ಕೇಳಿದಾಗ	kannada
نستعلیق	arabic
ਲੲੀ	punjabi
தாழ்த்தப்பட்ட	tamil
ER	latin
ડિપાર્ટમેન્ટ	gujarati
అందుబాటులోకి	telugu
ਚਾਲਕ	punjabi
determines	latin
அரவிந்த்	tamil
വലിപ്പവും	malayalam
Genetics	latin
માઉસ	gujarati
मानाने	deva
రంపచోడవరంలోనూ	telugu
సెకండరీ	telugu
శ్లోకం	telugu
മാവോ	malayalam
चित्रपटसृष्टीतील	deva
ಕಾರ್ಯರೂಪಕ್ಕೆ	kannada
তীক্ষ্ণ	ben_ass
ఏమిటంటే	telugu
unanimously	latin
kartaat	latin
બદલાવ	gujarati
arindu	latin
வழிபடும்	tamil
உடைந்து	tamil
اوسر	arabic
மாஸ்கோ	tamil
போரின்போது	tamil
পানামা	ben_ass
1607	latin
വിശദാംശങ്ങൾ	malayalam
ਚੜ੍ਹ	punjabi
معاذ	arabic
মূল্যবোধ	ben_ass
ਕੁੱਤੇ	punjabi
परळी	deva
assignments	latin
agadi	latin
ਪ੍ਰਸ਼ਨ	punjabi
ديش	arabic
جيوت	arabic
ਤਲਾਸ਼	punjabi
പഠനത്തിനു	malayalam
పెట్టుబడి	telugu
చనిపోయిన	telugu
സ്വാതി	malayalam
बाथरूम	deva
Seal	latin
മുറിയിൽ	malayalam
చారిత్రిక	telugu
புலவர்களில்	tamil
سہارنپور	arabic
ਚਲਦੀ	punjabi
सियासत	deva
शिवाजीराव	deva
رھائش	arabic
ವ್ಯಕ್ತಿತ್ವದ	kannada
बध	deva
होइनन्	deva
സിപിഐ	malayalam
ਕਿਸ਼ਨ	punjabi
મોરવા	gujarati
હરાવી	gujarati
விருதுகளில்	tamil
സസ്യകുടുംബത്തിലെ	malayalam
مونٹینیگرو	arabic
آمیز	arabic
উদ্বোধনে	ben_ass
रुखको	deva
ভায়েক	ben_ass
ಮೆಡಿಸಿನ್	kannada
किलोमीटर्मिते	deva
দুবার	ben_ass
kamishner	latin
আধান	ben_ass
اجماع	arabic
তললৈ	ben_ass
নকৰিলে	ben_ass
ಮತದಾನದ	kannada
हस्तियों	deva
ويٺي	arabic
ಕಾಮ್	kannada
اسکرین	arabic
వరద	telugu
Mythology	latin
1694	latin
कल्पित	deva
ટેક્નોલોજી	gujarati
ಆರ್ಯ	kannada
ਬੀਰ	punjabi
ಸ್ಥೂಲ	kannada
வல்லுநர்	tamil
عَلَى	arabic
നങ്ങള്	malayalam
సంగతులు	telugu
ಸ್ಥಳದಿಂದ	kannada
വൈഡ്	malayalam
പൊതുമേഖലാ	malayalam
1709	latin
அமராவதி	tamil
yatriyon	latin
પિતાની	gujarati
షెడ్	telugu
ಸಂಪುಟದಲ್ಲಿ	kannada
ডাক্তারের	ben_ass
ಕನ್ನಡಿಗರ	kannada
ignorant	latin
ਸੈਂਟ	punjabi
ടെക്സ്റ്റ്	malayalam
பெயர்க்காரணம்	tamil
ਪੌਦਾ	punjabi
સુઈગામ	gujarati
नागनाथ	deva
മോചനം	malayalam
rahate	latin
સંરક્ષિત	gujarati
১০৭	ben_ass
शिर्ष	deva
notorious	latin
گاہوں	arabic
২২টি	ben_ass
विजयः	deva
ਜਸਵਿੰਦਰ	punjabi
ರಕ್ಷಣೆಯನ್ನು	kannada
மொழிகளை	tamil
ਰੂਟ	punjabi
આગળના	gujarati
માતાના	gujarati
ਇਰਾਨੀ	punjabi
അപ്പോഴും	malayalam
902	latin
ಮೂಲಕವೇ	kannada
જીરૂ	gujarati
ಸಿಸ್ಟಮ್ಸ್	kannada
११३	deva
മരിക്കുകയും	malayalam
ಪ್ರಣಯ	kannada
নির্মম	ben_ass
કંટ્રોલ	gujarati
ਫਿਲਮੋਗ੍ਰਾਫੀ	punjabi
hongi	latin
पन्ध्र	deva
ਜਿਬਰਾਲਟਰ	punjabi
జస్టిస్	telugu
பண்டிதர்	tamil
प्रतिबंधक	deva
நாயகம்	tamil
లెక్క	telugu
அமேசான்	tamil
ಕೆಲಸಗಾರರು	kannada
ਬੱਜਬੱਜ	punjabi
నిర్వహిస్తుంది	telugu
parivahan	latin
ਨਿਯਮਿਤ	punjabi
દિવ્ય	gujarati
मुक्काम	deva
എന്നതിനു	malayalam
کریمیا	arabic
ਰਫ਼ਤਾਰ	punjabi
Clarendon	latin
মিত্ৰ	ben_ass
ഉദ്ഭവം	malayalam
બંન્ને	gujarati
நோக்கிப்	tamil
அனுப்பிய	tamil
ਮਿਲੀਆਂ	punjabi
ಕಾಂ	kannada
ഗബ്രിയേൽ	malayalam
ਹਾਜ਼ਰ	punjabi
ਲਾਂਚ	punjabi
ماڪڙ	arabic
الوجبات	arabic
ہندُستٲنُک	arabic
பயிற்சியாளர்	tamil
বিশ্বত	ben_ass
ਗਿਣਿਆ	punjabi
सहजता	deva
கொல்லப்பட்ட	tamil
महानगराय	deva
মাঝের	ben_ass
ਐਸਿਡ	punjabi
பெற்றிருந்தது	tamil
எல்லையாக	tamil
ಕಾಡುಗಳಲ್ಲಿ	kannada
বর্ষপঞ্জী	ben_ass
സംയുക്തങ്ങൾ	malayalam
കുടിയേറ്റ	malayalam
ರಂಗದ	kannada
മാർപ്പാപ്പയുടെ	malayalam
982	latin
Bundesliga	latin
தயாரிக்கப்பட்டு	tamil
விளிம்பு	tamil
పత్తి	telugu
آفریدی	arabic
కుతుబ్	telugu
ട്വന്റി	malayalam
চন্দন	ben_ass
ਲੰਗਰ	punjabi
കാന്തിമാനം	malayalam
દલિત	gujarati
నైపుణ్యం	telugu
കാരണമായ	malayalam
ਸਕਿੰਟ	punjabi
കിട്ടും	malayalam
ચળવળમાં	gujarati
ਗਾਰਡਨ	punjabi
मोटाई	deva
നമ്പൂതിരിപ്പാട്	malayalam
അഫ്ഗാനിസ്താൻ	malayalam
ਚੌਹਾਨ	punjabi
আচ্ছাদিত	ben_ass
ഭാഷയെ	malayalam
கூட்டுப்	tamil
ಕಲ್ಪನೆಯ	kannada
ಸ್ಟೋರ್	kannada
iyakuner	latin
रक्षात्मक	deva
crafted	latin
दारा	deva
ചിലര്	malayalam
అందుకని	telugu
ठेवत	deva
ਪਰਖ	punjabi
ইতোমধ্যেই	ben_ass
Mallya	latin
రెట్లు	telugu
విజయాలు	telugu
unrest	latin
ಫಲಿತಾಂಶವನ್ನು	kannada
లేత	telugu
પગલા	gujarati
ইম	ben_ass
અભ્યાસો	gujarati
சுரங்க	tamil
hereditary	latin
વાપરે	gujarati
ਖਰੜ	punjabi
vivah	latin
ভেজা	ben_ass
ಉಲ್ಲೇಖವಿದೆ	kannada
మనము	telugu
ഉത്തർ	malayalam
hindus	latin
भट्टराईले	deva
సీజన్	telugu
2001ರ	kannada
મહિલાઓને	gujarati
કાશી	gujarati
Fitness	latin
दीव	deva
ਰਾਜਨੇਤਾ	punjabi
Mon	latin
எதிர்ப்புத்	tamil
नकुल	deva
పార్టీని	telugu
sanghathanon	latin
وں	arabic
طبقو	arabic
અભિપ્રાય	gujarati
छवियों	deva
লক	ben_ass
కాలంలోనే	telugu
बनेपा	deva
ક્ષેત્રને	gujarati
اونچائی	arabic
સાચું	gujarati
લક્ષ્યાંક	gujarati
தமிழகப்	tamil
बढाएको	deva
అగ్రహారంలో	telugu
கேட்டேன்	tamil
ಬಂದರೂ	kannada
Didn	latin
క్రొత్త	telugu
পাকিস্তানকে	ben_ass
நுகர்வு	tamil
taal	latin
ਚਿਕਿਤਸਾ	punjabi
ਰਾਖੀ	punjabi
अन्तर्गतका	deva
17வது	tamil
ಬಾಲ್ಟಿಮೋರ್	kannada
నరేష్	telugu
3d	latin
ਆਨਰਜ਼	punjabi
অ্যাসোসিয়েশনের	ben_ass
బడి	telugu
గళామృతము	telugu
എംഎല്	malayalam
ಮೋರ್	kannada
ਪਾਰਸੀ	punjabi
నదికి	telugu
squares	latin
પાના	gujarati
Humboldt	latin
മലയാളത്തിലും	malayalam
നാസ	malayalam
ಸ್ಥಾನದ	kannada
വികസിപ്പിച്ചു	malayalam
پليجو	arabic
ആകാശം	malayalam
வேறுபடும்	tamil
ਅਲੋਪ	punjabi
ਖੇਡਦੇ	punjabi
સંવર્ધન	gujarati
ગેરકાયદેસર	gujarati
सरकारमध्ये	deva
ਉਦਾਹਰਨਾਂ	punjabi
caryakar	latin
فرقوں	arabic
બૌદ્ધિક	gujarati
ತಯಾರಿಸಲಾದ	kannada
फुटेज	deva
೧೯೫೫	kannada
സാർ	malayalam
ਭ੍ਰਿਸ਼ਟਾਚਾਰ	punjabi
গ্রীন	ben_ass
प्रकरणी	deva
سرحدوں	arabic
ਵੈੱਬ	punjabi
പര്യടനം	malayalam
ബില്യൺ	malayalam
چمک	arabic
ड्राइविंग	deva
चाललेल्या	deva
૧૯૮૬	gujarati
اوھان	arabic
ਜੋਤੀ	punjabi
ارغونن	arabic
ಬೆಳೆಸಲು	kannada
प्रसस्त	deva
ਕਾਸ਼ਤ	punjabi
ஒரிசா	tamil
யாழ்ப்பாணப்	tamil
മുന്നേ	malayalam
৫টা	ben_ass
balcony	latin
செய்ததாக	tamil
জয়ী	ben_ass
2000ના	gujarati
ગામનું	gujarati
عاجز	arabic
ടീ	malayalam
எல்லாக்	tamil
interpretations	latin
सुगंधित	deva
ਫੂਲ	punjabi
ತೆಗೆದುಕೊಂಡಿತು	kannada
நடிகையாக	tamil
நோய்க்கு	tamil
ਬਾਦਸ਼ਾਹੀ	punjabi
ತೆಗೆಯುವ	kannada
सराफ	deva
காளான்	tamil
लैजाने	deva
ਖਤਰੇ	punjabi
ക്ലബ്ബിന്റെ	malayalam
ম্যাট্রিক্স	ben_ass
ನಾರು	kannada
చలం	telugu
કાકા	gujarati
ராகவன்	tamil
ষ্টেট	ben_ass
பதம்	tamil
শিক্ষানুষ্ঠান	ben_ass
സൾഫർ	malayalam
অভ্যর্থনা	ben_ass
পৰিধান	ben_ass
conclude	latin
വസ്തുക്കളെ	malayalam
سمجهه	arabic
পত্রিকায়	ben_ass
धीमा	deva
નિષ્ક્રિય	gujarati
مادری	arabic
పత్రాలు	telugu
ಪಟ್ಟ	kannada
భాషల	telugu
ఆవు	telugu
Meherpur	latin
പഠനത്തിന്	malayalam
മകളും	malayalam
کشیدگی	arabic
ভরসা	ben_ass
फारूक	deva
பலவற்றை	tamil
জ্বলে	ben_ass
मुला	deva
മിസൈൽ	malayalam
ಅರ್ಥಶಾಸ್ತ್ರದ	kannada
റിപ്പോർട്ടുകൾ	malayalam
ಬೀಟಾ	kannada
ਸਬਜ਼ੀਆਂ	punjabi
ఐరోపాలో	telugu
പറയാന്	malayalam
ਜੋਸ਼	punjabi
कर्मयोगी	deva
విశాలమైన	telugu
২৩শে	ben_ass
కారణాల	telugu
ಸಮೃದ್ಧ	kannada
निपटान	deva
conection	latin
ಸ್ಥಾಪಿತವಾಯಿತು	kannada
బ్యాంకుగ్రామంలో	telugu
कायद्याच्या	deva
ਕੁਆਲੀਫਾਈ	punjabi
ల్లో	telugu
మనకి	telugu
વ્યક્તિઓની	gujarati
حياتيات	arabic
ਵਿੱਦਿਅਕ	punjabi
তাপীয়	ben_ass
ਨਿਬੰਧਕਾਰ	punjabi
వేగంతో	telugu
LPG	latin
ਮਨਾਹੀ	punjabi
सकेसम्म	deva
નદીનો	gujarati
മണ്ണിന്റെ	malayalam
وقفہ	arabic
پکيءَ	arabic
అఖిల	telugu
உலகெங்கிலும்	tamil
એકબીજાને	gujarati
પદ્ધતિનો	gujarati
ક્યાંક	gujarati
மேல்நிலை	tamil
ਕਰਵੇਚਰ	punjabi
சீதை	tamil
ফোর্ড	ben_ass
ನಾರಾಯಣ್	kannada
कॅमेरा	deva
ఇంగ్లీషులో	telugu
ਸਰਵਰ	punjabi
ਸਪੀਸੀਜ਼	punjabi
বাড়ানো	ben_ass
সর্পিলাকার	ben_ass
ਲੇਬਰ	punjabi
వయస్సులో	telugu
வளர்ச்சியும்	tamil
Shrine	latin
894	latin
অ্যাডাম	ben_ass
বাড়বে	ben_ass
பீகாரின்	tamil
விவரிக்கும்	tamil
ക്രിസ്തുമസ്	malayalam
ਸੰਘੀ	punjabi
Dutta	latin
बाथ	deva
ડિસ્કવરી	gujarati
ઉદ્યોગપતિ	gujarati
ಕವಿಗಳ	kannada
వెల్లడించారు	telugu
ਇੰਡਸਟਰੀ	punjabi
ಮೂಲವಾಗಿ	kannada
நாங்க	tamil
ధ్వంసం	telugu
कीटों	deva
अधिनमा	deva
दिनहरूमा	deva
അംഗ	malayalam
روا	arabic
આંગણવાડીની	gujarati
niryathan	latin
ਜ਼ਿਲ੍ਹਿਆਂ	punjabi
عهدو	arabic
నాణ్యత	telugu
திரும்பவும்	tamil
ಕೆಳಭಾಗದಲ್ಲಿ	kannada
క్రమం	telugu
जीविका	deva
பிரபலம்	tamil
ದೊರಕಿವೆ	kannada
વેતન	gujarati
ಕೊಂಡಿ	kannada
போதைப்	tamil
രേവതി	malayalam
கணக்கான	tamil
marrow	latin
രൂപംകൊണ്ട	malayalam
சமூகத்	tamil
adyam	latin
ਕੇਸਾਂ	punjabi
ஒவ்வோர்	tamil
بھوشن	arabic
সম্ভ্রান্ত	ben_ass
ఇంధనం	telugu
ব্যাকটেরিয়া	ben_ass
येताना	deva
ಪ್ರೇಕ್ಷಕರು	kannada
தாமசு	tamil
ਹਕੀਕਤ	punjabi
போன்றவற்றைக்	tamil
செல்வர்	tamil
വിജയമായിരുന്നു	malayalam
MSN	latin
பிரிவுகளாகப்	tamil
Landing	latin
ಕಾನ್ಸಾಸ್	kannada
ಅಭಿವೃದ್ಧಿಯನ್ನು	kannada
ತುಪ್ಪ	kannada
ڏڪار	arabic
وسٹا	arabic
ફિલ્મનું	gujarati
मनो	deva
അധിനിവേശം	malayalam
അലാസ്ക	malayalam
ખેલ	gujarati
942	latin
बिहारको	deva
Enterprises	latin
கிரிக்	tamil
തയ്യാറാക്കിയത്	malayalam
ਜਾਗਰੂਕਤਾ	punjabi
યોજાયેલી	gujarati
ಆಕಾರವನ್ನು	kannada
ഏർപ്പെട്ടു	malayalam
ಆಯ್ಕೆಯನ್ನು	kannada
ಸಾಗಿಸುವ	kannada
കൃതികളുടെ	malayalam
Yamuna	latin
ਔਖਾ	punjabi
വളരെക്കാലം	malayalam
ವಿಶೇಷತೆ	kannada
سنکیانگ	arabic
वंशाचे	deva
இப்பள்ளி	tamil
ਰਾਜਦੂਤ	punjabi
যেদিন	ben_ass
ट्रेंड	deva
સમિતિના	gujarati
మందిని	telugu
गूढ	deva
ठरत	deva
உதவியாளர்	tamil
উই	ben_ass
مولود	arabic
socialism	latin
કેપિટલ	gujarati
दृश्यहरू	deva
navigate	latin
ಪಡೆದಿತ್ತು	kannada
કબર	gujarati
வெல்ல	tamil
ಆತಿಥ್ಯ	kannada
প্রিমিয়ার	ben_ass
ஒன்றிணைந்து	tamil
ಗಿಡಗಳು	kannada
وٺندي	arabic
سرائي	arabic
વિસ્ફોટ	gujarati
கூழ்	tamil
explanations	latin
প্রাইমটাইম	ben_ass
ಹರಡಿತು	kannada
సరిహద్దులు	telugu
صديون	arabic
એજન્સીઓ	gujarati
wonders	latin
अनुमोदित	deva
സെഞ്ച്വറി	malayalam
దసరా	telugu
jokhim	latin
টমেটো	ben_ass
إن	arabic
ರಾಜಕುಮಾರ	kannada
તાવ	gujarati
সেইসব	ben_ass
sahyogi	latin
supplying	latin
ਜਾਣਦਾ	punjabi
కాకినాడలోను	telugu
ರಾಬಿನ್	kannada
આંકડાકીય	gujarati
churi	latin
ਮਾਮੂਲੀ	punjabi
ઇન્ક	gujarati
تفاوت	arabic
ഭക്ഷണസസ്യങ്ങൾ	malayalam
ಹೆಂಗಸರು	kannada
chuttee	latin
நோக்கத்துடன்	tamil
mianmar	latin
ಸಂಘಗಳ	kannada
तस्यै	deva
ਮੋਰਚੇ	punjabi
நேர்மறையான	tamil
ਅਲਜਬਰੇ	punjabi
செங்குத்தாக	tamil
ਹਥਿਆਰਬੰਦ	punjabi
మించిన	telugu
పొరుగు	telugu
జుట్టు	telugu
പുരാണം	malayalam
ماسٽر	arabic
confession	latin
अनवरत	deva
സന്ധി	malayalam
કરવામા	gujarati
કહેવાતા	gujarati
किलोमीटर्	deva
কচি	ben_ass
పెరుగుతున్న	telugu
వహిస్తుంది	telugu
ಕಾರಣಗಳಿಗಾಗಿ	kannada
அடக்கி	tamil
الٰہیات	arabic
وصيت	arabic
സിങ്ങിന്റെ	malayalam
অত	ben_ass
ترغیب	arabic
Hardik	latin
ladai	latin
మాస్	telugu
शर्मिला	deva
ਰੱਖਦੀਆਂ	punjabi
നീര്	malayalam
Taluk	latin
ਪ੍ਰਮਾਣਿਤ	punjabi
whili	latin
ৰবীন্দ্ৰনাথ	ben_ass
aandolan	latin
മറൈൻ	malayalam
செய்வார்	tamil
চিতা	ben_ass
ਮੁਖਰਜੀ	punjabi
டீன்	tamil
ক্ষেত্রফল	ben_ass
ਫੈਲੋਸ਼ਿਪ	punjabi
রাখি	ben_ass
ਸਤ੍ਹਾ	punjabi
ਸੱਭ	punjabi
ميوزڪ	arabic
স্ট্যান্ড	ben_ass
સરકારો	gujarati
અગત્યની	gujarati
ಪಂಪ	kannada
नक्शे	deva
मोडक	deva
ਅਜੀਬ	punjabi
স্নেহ	ben_ass
reasonably	latin
ٽڪيٽ	arabic
उद्यमाः	deva
മഴക്കാലത്ത്	malayalam
shampoo	latin
ಲಲಿತ	kannada
طیاروں	arabic
ઘરો	gujarati
ലഹള	malayalam
প্রতিষ্ঠায়	ben_ass
மலைத்	tamil
నాగయ్య	telugu
ਸੈੱਲਾਂ	punjabi
લેવાતી	gujarati
Midwest	latin
ہنگری	arabic
কুলি	ben_ass
ਆਪੋ	punjabi
గ్రామంప్రధాన	telugu
firie	latin
தடித்த	tamil
ಪ್ರಭಾವಶಾಲಿ	kannada
శతాబ్దాల	telugu
ಆಶ್ರಯದಲ್ಲಿ	kannada
अवयवों	deva
ఎడిటర్	telugu
ಲೆವಿಸ್	kannada
ಬಿಜೆಪಿಯ	kannada
മോഡേൺ	malayalam
শনি	ben_ass
ਸਾਹਿਤਿਕ	punjabi
হনুমান	ben_ass
ਰੇਤ	punjabi
కృత్రిమ	telugu
കോവിൽ	malayalam
उत्तमम्	deva
സമ്പത്ത്	malayalam
disclosed	latin
Uma	latin
ঠায়ে	ben_ass
8வது	tamil
ഗ്രന്ഥമായ	malayalam
অস্কাৰ	ben_ass
Missile	latin
ਮਕਾਨ	punjabi
004	latin
Ah	latin
کردیتا	arabic
അവിടെയുള്ള	malayalam
അറിയില്ല	malayalam
ਫੈਲਣ	punjabi
ప్రభుత్వము	telugu
ഹെലൻ	malayalam
बैठकों	deva
pooran	latin
વાયરસ	gujarati
સમુદ્રના	gujarati
تور	arabic
உதவித்	tamil
হরি	ben_ass
നീളുന്ന	malayalam
उपाययोजना	deva
ਖੇਡਣਾ	punjabi
ਸਮਾਪਤ	punjabi
గోల్డ్	telugu
இடத்தின்	tamil
मृणाल	deva
విశేషంగా	telugu
كتاب	arabic
వదలబడుతోంది	telugu
லேசர்	tamil
ಕರಡು	kannada
ਯਹੂਦੀਆਂ	punjabi
tyaancha	latin
घरका	deva
prolonged	latin
मानिएका	deva
ಚೆನೈ	kannada
રમતના	gujarati
വിശദീകരിക്കുന്നു	malayalam
દીક્ષા	gujarati
പുലർച്ചെ	malayalam
ശബ്	malayalam
অনানুষ্ঠানিক	ben_ass
చెబుతాడు	telugu
नम्रता	deva
ਪੱਕੀ	punjabi
Nirmala	latin
چٹان	arabic
حوا	arabic
मेड	deva
ಟ್	kannada
పరమాణు	telugu
ਬੈਲਜੀਅਮ	punjabi
પોર્ટલેન્ડ	gujarati
बिजनौर	deva
बनतो	deva
चोरों	deva
നഷ്ടമായി	malayalam
ਤਜਰਬੇ	punjabi
ਭੱਟੀ	punjabi
നോവലിലെ	malayalam
ರಾಷ್ಟ್ರಗಳಿಗೆ	kannada
బ్రాహ్మణుడు	telugu
طاری	arabic
திங்கட்கிழமை	tamil
প্রতিনিয়ত	ben_ass
राजन्	deva
கருதலாம்	tamil
உதாரணங்கள்	tamil
দহন	ben_ass
ముగింపు	telugu
কাষৰীয়া	ben_ass
প্ৰতিফলিত	ben_ass
১৮৩৫	ben_ass
शील्ड	deva
રિપોર્ટ	gujarati
ਹਾਨ	punjabi
পৃথকভাবে	ben_ass
মেমোরি	ben_ass
غزلیں	arabic
૧૯૩૯	gujarati
ਟੌਪੌਲੌਜੀ	punjabi
ਜਾਪਦਾ	punjabi
کرسی	arabic
नवनिर्माण	deva
இப்படித்தான்	tamil
વાતને	gujarati
ವಿಮಾನವು	kannada
হ্যারিস	ben_ass
ਜੋਨਸ	punjabi
نڪي	arabic
ఐస్	telugu
ಇದ್ದೇ	kannada
কবিতাটি	ben_ass
ఆర్మేనియా	telugu
ਛੇਵੀਂ	punjabi
શકતું	gujarati
പിതാവും	malayalam
बुझाउँछ	deva
രവിവർമ്മ	malayalam
swa	latin
അറിയാത്ത	malayalam
തീവ്രവാദ	malayalam
रंगनाथ	deva
ഭാരതം	malayalam
നിരന്തരമായ	malayalam
గ్రేడ్	telugu
બતાવવામાં	gujarati
ഉപരിതലത്തിൽ	malayalam
మాసం	telugu
இதழியல்	tamil
వెంకయ్య	telugu
ਭਾਰਤੀਆਂ	punjabi
ماريو	arabic
ಸರ್ಕಾರದಲ್ಲಿ	kannada
ಬಹುದೊಡ್ಡ	kannada
೧೯೪೦	kannada
अलेक्सा	deva
നോക്കിയ	malayalam
കളിയുടെ	malayalam
dull	latin
સેવ	gujarati
ఇందు	telugu
ಪ್ರಧಾನಮಂತ್ರಿ	kannada
ജീവിച്ച	malayalam
വഹിച്ചിരുന്നു	malayalam
মাঝ	ben_ass
हप्ताको	deva
അഭിനേത്രിയാണ്	malayalam
ಮರಿಗಳು	kannada
అక్రమ	telugu
تشبیہ	arabic
मानिसमा	deva
ફોર્બ્સ	gujarati
യ്ക്ക്	malayalam
रोलिन्स	deva
നയതന്ത്ര	malayalam
জালালাবাদ	ben_ass
बोलू	deva
പിയുടെ	malayalam
రాష్ట్రాల్లో	telugu
શ્યામ	gujarati
ദൈവ	malayalam
ভোটারদের	ben_ass
ઘટનાને	gujarati
அபராதம்	tamil
पुण्याचे	deva
ഷേർ	malayalam
சமாதானம்	tamil
گهرڙن	arabic
భద్రాచలం	telugu
നാനാ	malayalam
1995ರಲ್ಲಿ	kannada
సంవత్సర	telugu
ingtone	latin
ਕਲਮ	punjabi
സ്ത്രീകളിൽ	malayalam
రామన్	telugu
Lyons	latin
সুপারস্টার	ben_ass
HF	latin
নিৰ্দেশনা	ben_ass
महायुद्धादरम्यान	deva
vijaya	latin
ليلا	arabic
స్థానికులు	telugu
દેખાયા	gujarati
નાટ્ય	gujarati
പാമ്പ്	malayalam
ਹੈਮਿਲਟੋਨੀਅਨ	punjabi
చూసే	telugu
siri	latin
ڳولڻ	arabic
કૉલેજમાં	gujarati
వైస్	telugu
آهيو	arabic
शॉ	deva
فیصلوں	arabic
خروج	arabic
આગ્રહ	gujarati
چاچي	arabic
1882ء	arabic
2007ರಂದು	kannada
پهچايو	arabic
प्रतिपक्ष	deva
ಅನಿರೀಕ್ಷಿತ	kannada
എന്നിവയുൾപ്പെടെ	malayalam
resemble	latin
কীৰ্তন	ben_ass
പരുത്തി	malayalam
সাবমেরিন	ben_ass
சண்டிகேஸ்வரர்	tamil
দালান	ben_ass
என்னைக்	tamil
گنگ	arabic
ಕೌಶಲ್ಯ	kannada
എൻജിനീയറിങ്	malayalam
നിയോഗിച്ചു	malayalam
છઠ્ઠી	gujarati
aarmbh	latin
സ്മാരകങ്ങൾ	malayalam
బీమా	telugu
शिखरमा	deva
પારંપારિક	gujarati
ਬੀਜਾਂ	punjabi
ਵਿਆਹਿਆ	punjabi
पाठीवर	deva
উত্তরণ	ben_ass
വിഭാഗവും	malayalam
सत्यजित	deva
ત્રણે	gujarati
करौली	deva
ಹಸಿ	kannada
પીછો	gujarati
ਪੂਰੀਆਂ	punjabi
1733	latin
1240	latin
മന്ദിരം	malayalam
শ্রীমঙ্গল	ben_ass
ബീഗം	malayalam
ਸੈਲਾਨੀ	punjabi
ਮਸ਼ੀਨਾਂ	punjabi
ਸਥਿਰਾਂਕ	punjabi
तिथेच	deva
८५०	deva
नापी	deva
पटकावले	deva
ಗಾಳಿಯನ್ನು	kannada
شہ	arabic
પડકાર	gujarati
ದಿವಂಗತ	kannada
1529	latin
ഫെലോഷിപ്പ്	malayalam
നൽകണം	malayalam
ਲੜੀਆਂ	punjabi
വെവ്വേറെ	malayalam
నేటికీ	telugu
पाठवून	deva
అన్నపూర్ణ	telugu
పోషించాడు	telugu
ಕಚೇರಿಯ	kannada
ઓલ્ડ	gujarati
पसरलेले	deva
പലവിധ	malayalam
ਖੜ੍ਹਾ	punjabi
போவதாக	tamil
మొదటిది	telugu
انجم	arabic
ચે	gujarati
ਲਾਭਦਾਇਕ	punjabi
યુએન	gujarati
ঘৰতে	ben_ass
ಮಗನಾಗಿ	kannada
மீனா	tamil
பிரதர்ஸ்	tamil
ಹಳೆಯದಾದ	kannada
பரபரப்பை	tamil
विद्यमानस्य	deva
બીજુ	gujarati
ਖੜ੍ਹੇ	punjabi
اڳواٽ	arabic
Judgment	latin
মগজুৰ	ben_ass
ಗ್ರಂಥಸೂಚಿ	kannada
ಹಬ್ಬವನ್ನು	kannada
இராமச்சந்திரன்	tamil
உள்ளூராட்சி	tamil
அன்ட்	tamil
1558	latin
ವರ್ಗಗಳು	kannada
बादलों	deva
ચેક	gujarati
அறியப்பட்டுள்ளது	tamil
பறிமுதல்	tamil
పప్పు	telugu
ಕೆವಿ	kannada
குஜராத்தி	tamil
அநேக	tamil
വഴികൾ	malayalam
ನಡೆಯುವುದು	kannada
പശ്ചിമഘട്ടത്തിൽ	malayalam
Crossing	latin
ईस्टर	deva
Arif	latin
GO	latin
আগশাৰীৰ	ben_ass
ತಂಡದಿಂದ	kannada
yarn	latin
معدنيات	arabic
ਹਰਗੋਬਿੰਦ	punjabi
పెద	telugu
గుంతకల్లు	telugu
একটির	ben_ass
ത്രം	malayalam
బాపు	telugu
സ്കൂളിന്റെ	malayalam
ਤੀਸਰੇ	punjabi
glance	latin
விரைவிலேயே	tamil
রেট	ben_ass
એકર	gujarati
മനസ്സിലായി	malayalam
Sharad	latin
સાતમી	gujarati
വഴിപാടുകൾ	malayalam
businesspeople	latin
જોશી	gujarati
ਉਲੰਪਿਕ	punjabi
ஒப்பீடு	tamil
غروب	arabic
remand	latin
ਸਾਹਿਬਾਂ	punjabi
16મી	gujarati
സോണി	malayalam
સર્જનાત્મક	gujarati
समासः	deva
ఆత్రేయ	telugu
MGR	latin
ಡಿಸ್	kannada
कांस्टेबल	deva
શીખો	gujarati
ആരാണ്	malayalam
അംഗീകൃത	malayalam
ਪ੍ਰਯੋਗਾਂ	punjabi
அங்குல	tamil
ছাড়	ben_ass
سرائيڪي	arabic
વરાળ	gujarati
ਔਲਖ	punjabi
کریڈٹ	arabic
കാഴ്ചയിൽ	malayalam
మినహా	telugu
ਸੋਮਵਾਰ	punjabi
കമ്മീഷണർ	malayalam
laghu	latin
ഡെൽറ്റ	malayalam
ಆಸ್ಪತ್ರೆಗಳು	kannada
जनवि	deva
Howe	latin
ാമത്	malayalam
உற்பத்திப்	tamil
മൂലമുണ്ടാകുന്ന	malayalam
പുരാണങ്ങളിൽ	malayalam
ঝড়ের	ben_ass
manav	latin
ਉਹਨੂੰ	punjabi
பிர	tamil
ڀڳوان	arabic
ರಕ್ತದಲ್ಲಿ	kannada
നിയമങ്ങളും	malayalam
സൃഷ്ടിക്കുകയും	malayalam
Conquest	latin
ਵੱਸ	punjabi
மீண்டு	tamil
જાન	gujarati
પ્રસંગ	gujarati
જઇને	gujarati
சுனாமி	tamil
ڏاڍ	arabic
خدائی	arabic
இருக்குமாறு	tamil
സാധ്യതയുള്ള	malayalam
જોરદાર	gujarati
നോട്ടീസ്	malayalam
ત્રીજું	gujarati
ਵਿੰਡੋਜ਼	punjabi
हजेरी	deva
கணக்கியல்	tamil
அமிலத்தை	tamil
சந்தோஷ்	tamil
జైలులో	telugu
Sutherland	latin
ಬಂಧನ	kannada
practitioner	latin
നിലത്ത്	malayalam
করাও	ben_ass
ஒட்டுமொத்தமாக	tamil
अस्पृश्यता	deva
elu	latin
UPSC	latin
பிரச்சனைகளை	tamil
ಪಾಲನೆ	kannada
ಸೂಚಕ	kannada
ਡਿਜ਼ਨੀ	punjabi
ಭಾಗವಾದ	kannada
ಗಮನಿಸಿದ	kannada
سیراب	arabic
কাজও	ben_ass
शकणार	deva
इतरत्र	deva
Item	latin
समाजों	deva
હાર્ડવેર	gujarati
ವೈರ್	kannada
తెలియ	telugu
സ്വാധീനിച്ച	malayalam
સ્ટીવ	gujarati
యుద్ధము	telugu
வெளிவந்தன	tamil
অপব্যবহার	ben_ass
చందమామ	telugu
ভাইৰাছৰ	ben_ass
বিলিয়ন	ben_ass
నిర్మాతగా	telugu
సంభవించిన	telugu
പതിവായിരുന്നു	malayalam
நேர்மறை	tamil
பிராந்தியத்தின்	tamil
வீழ்த்தினார்	tamil
સૂચક	gujarati
హిందీలో	telugu
काटी	deva
গ্রাহকের	ben_ass
ৱিকিপিডিয়াসমূহ	ben_ass
పదవ	telugu
മാഞ്ചസ്റ്റർ	malayalam
മഹാരാജാവിന്റെ	malayalam
ਬਗਾਵਤ	punjabi
లింగ	telugu
చేయమని	telugu
മരണങ്ങൾ	malayalam
ಋಷಿ	kannada
Bahamas	latin
તુલનાત્મક	gujarati
ڪمان	arabic
आल्बर्ट	deva
जेएनयू	deva
முதலமைச்சர்கள்	tamil
നാണയം	malayalam
மறுத்தார்	tamil
അപകടത്തിൽ	malayalam
દેવો	gujarati
১৮২৮	ben_ass
ಉಷ್ಣಾಂಶ	kannada
વેલ્સ	gujarati
बड़ौदा	deva
radha	latin
വിരൽ	malayalam
ആനയെ	malayalam
ફુટબોલ	gujarati
हालचाली	deva
೨೦೧೧ರ	kannada
ప్రెసిడెంట్	telugu
ఇతరుల	telugu
ਜ਼ੁਲਮ	punjabi
ਚੁਣ	punjabi
ಮೂಡಿ	kannada
न्यूट्रॉन	deva
জাতিসংঘে	ben_ass
ওজা	ben_ass
stint	latin
ಮಾರುಕಟ್ಟೆಯನ್ನು	kannada
वकीलों	deva
தெய்வமாக	tamil
ఇబ్న్	telugu
ಅಸ್ತಿತ್ವದಲ್ಲಿವೆ	kannada
పెంచి	telugu
కాలెండరు	telugu
خانه	arabic
வெறுப்பு	tamil
dube	latin
ಸುಂದರವಾಗಿ	kannada
যুদ্ধক্ষেত্রে	ben_ass
ادیبوں	arabic
വിശ്വാസത്തിന്റെ	malayalam
tele	latin
निरोप	deva
ಅಳೆಯುವ	kannada
പ്രദേശങ്ങളുടെ	malayalam
ಭಾಗವಾಗಿತ್ತು	kannada
ਪਾਰਵਤੀ	punjabi
যোনি	ben_ass
ਵਿਕਟ	punjabi
విమర్శకులు	telugu
ਨਾਨੀ	punjabi
nihaayat	latin
ಕಲ್ಪಿಸುತ್ತದೆ	kannada
گلابي	arabic
ਚਲਾਏ	punjabi
பொதுமக்களுக்கு	tamil
பன்னாட்டுக்	tamil
పూర్లో	telugu
पूर्णं	deva
ڄاڻائي	arabic
కాపర్	telugu
యువత	telugu
relevance	latin
गुजराथी	deva
वाचकांना	deva
కొత్తవీధి	telugu
సముద్రపు	telugu
ਕਿਊਬਾ	punjabi
அடிப்படையிலேயே	tamil
కాలములో	telugu
పుస్తకాల	telugu
ٽيسٽ	arabic
ભેદભાવ	gujarati
థామస్	telugu
જાડેજા	gujarati
கீரை	tamil
మెదడు	telugu
கில்	tamil
കാതൽ	malayalam
೫೨	kannada
ડેલ્ટા	gujarati
എമിലി	malayalam
ತಡೆಯುತ್ತದೆ	kannada
خمینی	arabic
સોંપી	gujarati
ఏమిటో	telugu
تعمیراتی	arabic
പറയുമ്പോൾ	malayalam
اجزا	arabic
શબ્દોનો	gujarati
ਮੱਧਕਾਲੀਨ	punjabi
পাঠাগার	ben_ass
এভারেস্ট	ben_ass
পাড়ি	ben_ass
चूहे	deva
Crimson	latin
সাক্ষরতা	ben_ass
shiny	latin
অনাতাঁৰ	ben_ass
लिखता	deva
abhivyakti	latin
अंबाला	deva
ਵਿਕਾਸਸ਼ੀਲ	punjabi
કારણભૂત	gujarati
ಗೀತೆಯನ್ನು	kannada
Alto	latin
చెడు	telugu
1855ء	arabic
ಎಡ್ಜ್	kannada
দেখলেন	ben_ass
ডিব্ৰুগড়ৰ	ben_ass
za	latin
अष्टाध्यायी	deva
અગત્યના	gujarati
ಜೈ	kannada
పురాణాలు	telugu
يڪدم	arabic
ٿڙ	arabic
என்பவர்கள்	tamil
ధైర్యం	telugu
അണുബാധ	malayalam
ਯੁਕਤ	punjabi
സുഖം	malayalam
বিন্যস্ত	ben_ass
కన్ను	telugu
గ్రెగోరియన్	telugu
ਜਿਹੀਆਂ	punjabi
ખાઈ	gujarati
পুরুষে	ben_ass
સ્પર્શ	gujarati
vadhare	latin
दातार	deva
ಅನುವಂಶಿಕ	kannada
ਵਿਰਕ	punjabi
பிரிவினை	tamil
গাঠনিক	ben_ass
گولیاں	arabic
சந்தைகள்	tamil
দুর্গম	ben_ass
వైదిక	telugu
এরশাদের	ben_ass
দুগৰাকী	ben_ass
વ્યાજ	gujarati
নকৰা	ben_ass
પ્રિફર્ડ	gujarati
વિથ	gujarati
ನಾಯಕನಾಗಿ	kannada
ছাত্রদল	ben_ass
ಅವೆಂದರೆ	kannada
പശു	malayalam
సమావేశాలు	telugu
మాయ	telugu
പില്ക്കാലത്ത്	malayalam
ബാലി	malayalam
ఛానల్	telugu
തെയ്യങ്ങൾ	malayalam
മനു	malayalam
ਹੜਤਾਲ	punjabi
انحراف	arabic
talaba	latin
1980ರಲ್ಲಿ	kannada
مهاتما	arabic
ਜਮੀਨ	punjabi
ഫ്രാന്	malayalam
ಪರಿಕಲ್ಪನೆಗಳು	kannada
வாக்குரிமை	tamil
আড়াই	ben_ass
karavi	latin
सर्पले	deva
ಪುತ್ತೂರು	kannada
ஒருத்தி	tamil
ವಾಹನದ	kannada
இந்தியாவுடன்	tamil
కాశీబుగ్గ	telugu
দলই	ben_ass
Rohingyas	latin
ઋતુ	gujarati
ಯೋಗ್ಯವಾದ	kannada
ಹೆಚ್ಚಾಗಿರುತ್ತದೆ	kannada
Akhter	latin
સ્વાભાવિક	gujarati
పూర్వీకులు	telugu
జిల్లాల్లో	telugu
চাঁদা	ben_ass
లక్ష్మీనారాయణ	telugu
గోడ	telugu
ഞങ്ങളെ	malayalam
উপনৈ	ben_ass
واڳون	arabic
আটজন	ben_ass
ورهائجي	arabic
ملاپ	arabic
തുമ്പികളുടെ	malayalam
ਪਰਿਭਾਸ਼ਤ	punjabi
હોકાયંત્ર	gujarati
सारखा	deva
పతాకంపై	telugu
ਨਿਯੁਕਤੀ	punjabi
इको	deva
નિર્દેશન	gujarati
జరుగును	telugu
கலம்	tamil
enthusiasts	latin
कामदेव	deva
விடயங்களை	tamil
प्रतिनिधिमंडल	deva
മുമ്പായി	malayalam
ਸ਼ੱਕਰ	punjabi
முத்துராமன்	tamil
வந்ததாக	tamil
कक्षेत	deva
ഫെയർ	malayalam
ਜੋੜਾ	punjabi
மையத்தை	tamil
খান্না	ben_ass
GJ	latin
సాహిత్యాన్ని	telugu
উপাসনালয়	ben_ass
ஆட்சியைக்	tamil
ഡേറ്റാബേസിൽ	malayalam
জনবল	ben_ass
ఇంజినీరింగ్	telugu
ಆರಂಭಿಸಲು	kannada
ആചാര്യ	malayalam
വിമർശകർ	malayalam
روضي	arabic
રાત્રિ	gujarati
നിലയങ്ങൾ	malayalam
જાણીતાં	gujarati
ಸಾಧನೆಗೆ	kannada
તાલાલા	gujarati
সন্ধানত	ben_ass
ছালৰ	ben_ass
મીઠી	gujarati
நிகழ்வுகளின்	tamil
సమగ్ర	telugu
ساقي	arabic
Loop	latin
ಗುರುತಿಸುವುದು	kannada
dementia	latin
ಸಂಕೇತವಾಗಿ	kannada
இத்திட்டத்தின்	tamil
సంజయ్	telugu
కళ్యాణ	telugu
செவிலியர்	tamil
இவ்வினை	tamil
جوانيءَ	arabic
Commodore	latin
ஆக்சிஜன்	tamil
ਤਿਉਹਾਰਾਂ	punjabi
ದಕ್ಷ	kannada
pratibedne	latin
ಚಿಂತನೆಯ	kannada
മാനന്തവാടി	malayalam
ગણાવે	gujarati
اونچے	arabic
ગૂવેરા	gujarati
মোহাম্মাদ	ben_ass
خدائے	arabic
Eduardo	latin
दोषों	deva
പക്ഷികളെ	malayalam
Goodman	latin
seridante	latin
মালয়েছিয়া	ben_ass
ತರಕಾರಿಗಳು	kannada
লী	ben_ass
ವ್ಯಕ್ತಿಗಳಲ್ಲಿ	kannada
ওয়েবসাইটে	ben_ass
ਚਮਕ	punjabi
incentives	latin
ಪ್ರದರ್ಶನವು	kannada
মধ্যপ্রদেশ	ben_ass
മുഖ്യമന്ത്രിയായി	malayalam
సెర్బియా	telugu
ધર્મનો	gujarati
ಸೇವೆಗಾಗಿ	kannada
ಬಣ್ಣಕ್ಕೆ	kannada
कौमी	deva
ಪ್ರಚಾರದ	kannada
விண்வெளிப்	tamil
ಎಡಕ್ಕೆ	kannada
શતાબ્દી	gujarati
లింక్	telugu
سلسلۂ	arabic
లోతైన	telugu
ಹಕ್ಕಿಗಳ	kannada
તાપમાને	gujarati
ਦਿਲਚਸਪ	punjabi
ਧਾਤੂ	punjabi
ਕੰਡੇ	punjabi
ബ്രൂസ്	malayalam
قاصد	arabic
மேற்பட்டோர்	tamil
ಮಧುರ	kannada
வேர்கள்	tamil
అనువైన	telugu
માસ્ટર્સ	gujarati
ਬਚਾ	punjabi
నియమించారు	telugu
വികിരണം	malayalam
મ્યુચ્યુઅલ	gujarati
విత్తనాలు	telugu
ਕਾਰਾਂ	punjabi
தெரிவிக்கின்றனர்	tamil
নেজ	ben_ass
कुमाल	deva
delegate	latin
લેબલ	gujarati
ویت	arabic
೪೪	kannada
நத்தம்	tamil
ചിത്രശലഭമാണ്	malayalam
راجپوتن	arabic
চাৰিআলি	ben_ass
ಇಸ್ಲಾಮ್	kannada
નવાગામ	gujarati
ٻيلا	arabic
೨೦೧೦ರ	kannada
Philharmonic	latin
ধাতুৰ	ben_ass
Folklore	latin
ليکيو	arabic
مديرية	arabic
ಆಡು	kannada
برمنگھم	arabic
உருளைக்கிழங்கு	tamil
bhajp	latin
ਗਿਅਾ	punjabi
পাউডার	ben_ass
ಉದ್ದೇಶಗಳನ್ನು	kannada
ਸਟੋਰੀ	punjabi
உயர்நீதிமன்றம்	tamil
રહેવાસીઓ	gujarati
ನಾಯಕತ್ವದ	kannada
മനസ്സിന്റെ	malayalam
ആപ്പ്	malayalam
ಜಿಲ್ಲೆಗೆ	kannada
ইয়র্কে	ben_ass
લૈંગિક	gujarati
سالک	arabic
૧૯૪૦	gujarati
జార్ఖండ్	telugu
oceans	latin
താലൂക്കിന്റെ	malayalam
విధి	telugu
பெறுகின்றது	tamil
இல	tamil
ஜெய்சங்கர்	tamil
షెడ్యూల్	telugu
ఆదిలాబాద్లోనూ	telugu
اسپورٹس	arabic
oune	latin
ভবিষ্যদ্বাণী	ben_ass
ਜਿਨਾਂ	punjabi
ਸ਼ਹਾਦਤ	punjabi
اُڀري	arabic
భావాలు	telugu
மெயின்	tamil
ਏਅਰਲਾਈਨਜ਼	punjabi
Rodney	latin
ਬਹੁਤੀਆਂ	punjabi
என்பார்கள்	tamil
રાજ્યોની	gujarati
गर्नुहोस	deva
બેન્ડે	gujarati
அடிக்க	tamil
પડતાં	gujarati
టేబుల్	telugu
घले	deva
ತಿಳುವಳಿಕೆ	kannada
ஒளிரும்	tamil
ਜਿਹਨੂੰ	punjabi
കഥാപാത്രത്തിന്റെ	malayalam
دھول	arabic
सखा	deva
प्रबंधित	deva
भारतगणराज्यस्य	deva
ડબલ	gujarati
3ನೇ	kannada
ਮਿਲਾਪ	punjabi
സ്ഥലത്തിന്റെ	malayalam
Par	latin
മാതൃകകൾ	malayalam
ಶೈಲಿಯು	kannada
நூற்றுக்கும்	tamil
ذائقہ	arabic
ઈસ્ટ	gujarati
दशौं	deva
सहमती	deva
ફોર્મ	gujarati
హిమాచల్	telugu
ಹೆಸರೂ	kannada
خصوصا	arabic
ദുബൈ	malayalam
పాత్రలను	telugu
baarah	latin
ತರುವುದು	kannada
ഇലകൾക്ക്	malayalam
ਪਿੱਠ	punjabi
இவ்விரண்டு	tamil
અકબર	gujarati
മരുഭൂമിയിൽ	malayalam
డిప్యూటీ	telugu
அலகான	tamil
ਵਿਸਾਖੀ	punjabi
satisfactory	latin
ఆవిడ	telugu
sooner	latin
ਸੁਨੀਲ	punjabi
Flemish	latin
جلیں	arabic
عَلَىٰ	arabic
કામદારો	gujarati
प्रॉपर्टी	deva
సెక్షన్	telugu
ಸಮಾನತೆ	kannada
ചെയ്യാതെ	malayalam
ಪದ್ಯಗಳು	kannada
بيوس	arabic
വാസ്തവത്തിൽ	malayalam
আফতাব	ben_ass
பஞ்சாபின்	tamil
علمبردار	arabic
గురజాడ	telugu
keyword	latin
موڑے	arabic
ਵੰਨ	punjabi
કેમ્બ્રિજ	gujarati
ளது	tamil
operas	latin
সম্পাদকৰ	ben_ass
نت	arabic
ಕಾರ್ಖಾನೆಗಳು	kannada
કોટ	gujarati
ಕುಣಿತದ	kannada
ਦੇਹ	punjabi
বাবুর	ben_ass
ਲੱਗੀਆਂ	punjabi
பாதுகாத்தல்	tamil
افزائش	arabic
കേരളവർമ്മ	malayalam
ಬರಿಯ	kannada
উদযাপনের	ben_ass
कलन	deva
empowerment	latin
نوید	arabic
నిధులను	telugu
ಅಧೀನ	kannada
தோள்	tamil
ਜਮ੍ਹਾਂ	punjabi
கட்சியும்	tamil
ਅੰਬਾਲਾ	punjabi
چوڏهن	arabic
পেরু	ben_ass
roofs	latin
leukemia	latin
encompasses	latin
শদিয়া	ben_ass
દહીં	gujarati
கோளாறுகள்	tamil
لیلہ	arabic
ಟೋನಿ	kannada
தரவுத்	tamil
సీట్లు	telugu
സാറ	malayalam
कार्यका	deva
veda	latin
daavat	latin
யாத்திரைத்	tamil
ફરક	gujarati
مصائب	arabic
மறைமுகமாக	tamil
కిలోల	telugu
மனைவியான	tamil
வெடிக்கும்	tamil
stretches	latin
ചെയ്യാവുന്നതാണ്	malayalam
ആശയങ്ങളും	malayalam
આકસ્મિક	gujarati
پچائي	arabic
مشروب	arabic
مسجدون	arabic
एयरबस	deva
सिनियर	deva
చదివారు	telugu
آپﷺ	arabic
শ্ৰম	ben_ass
टप्पे	deva
ਸੁਖ	punjabi
கொண்டாடப்பட்டது	tamil
गेलं	deva
केल्याची	deva
বিশ্লেষক	ben_ass
തെറ്റായി	malayalam
দায়িত্বপ্রাপ্ত	ben_ass
رنگا	arabic
بہاماس	arabic
கொடுத்தனர்	tamil
asusth	latin
काया	deva
మతాన్ని	telugu
సదుపాయం	telugu
நேரடியான	tamil
آريه	arabic
कन्	deva
ਪਬਲਿਸ਼ਰਜ਼	punjabi
ઉભું	gujarati
બ્લડ	gujarati
teno	latin
شماري	arabic
आउछ	deva
कमांडो	deva
குறிப்பிட்டது	tamil
নিউটনের	ben_ass
nakaaratmak	latin
റെക്കോഡ്	malayalam
సందేహం	telugu
ഭൗതികശാസ്ത്രജ്ഞർ	malayalam
IAAF	latin
મધ્યસ્થ	gujarati
ਸ੍ਰੀਮਤੀ	punjabi
வார்	tamil
వాడికి	telugu
వే	telugu
شاديون	arabic
غزلوں	arabic
બીજે	gujarati
पायरी	deva
മന്ത്രം	malayalam
ਬੈਠਕ	punjabi
રેસલમેનિયા	gujarati
સાતમા	gujarati
জঙ্গলের	ben_ass
ਜਹਾਜ	punjabi
अंग्रेज़	deva
મંડળી	gujarati
موسوی	arabic
ભરેલા	gujarati
বরুণ	ben_ass
संस्थांचे	deva
മെമ്പർ	malayalam
అజ్నాలా	telugu
அவைகளின்	tamil
રાવણ	gujarati
डा०	deva
jithe	latin
ਜਥੇਬੰਦੀ	punjabi
હેન્રી	gujarati
વિવેકાનંદ	gujarati
Architect	latin
unheen	latin
पूछते	deva
سطحی	arabic
سمٹ	arabic
তালিকাটি	ben_ass
இப்பறவை	tamil
ತಂದುಕೊಟ್ಟಿತು	kannada
Meri	latin
ಜೋನ್	kannada
ઉપરી	gujarati
కాకినాడలోనూ	telugu
मौसी	deva
ನೆಲೆಯನ್ನು	kannada
विहीन	deva
ధరించిన	telugu
स्टार्टअप	deva
સ્વપ્ન	gujarati
വ്യക്തിക്ക്	malayalam
ആക്കം	malayalam
વિસાવદર	gujarati
نیلم	arabic
ಪೈನ್	kannada
investigative	latin
ಶಾರ್ಟ್	kannada
شناختی	arabic
ഷോർട്ട്	malayalam
ത്രിപുര	malayalam
ज़ि	deva
आईपी	deva
தொழிலாளி	tamil
ஆய்வகத்தில்	tamil
തീർച്ചയായും	malayalam
आँसू	deva
চশমা	ben_ass
മാറാൻ	malayalam
গুঞ্জন	ben_ass
ಮುಳವಾಡ	kannada
પ્રસિધ્ધ	gujarati
వరలక్ష్మి	telugu
ಸ್ವರ್ಣ	kannada
ರಂತಹ	kannada
काट्न	deva
১৪০০	ben_ass
વાસણો	gujarati
ಜೂ	kannada
قبو	arabic
که	arabic
ഖുര്	malayalam
ബച്ചൻ	malayalam
கற்பிக்கும்	tamil
পাওয়ায়	ben_ass
ಕೊಳ್ಳುವ	kannada
दिक्	deva
Globalization	latin
നിർമ്മിച്ചതാണ്	malayalam
سغد	arabic
അപ്പോഴേക്കും	malayalam
ಸಂಖ್ಯಾ	kannada
கூறியிருந்தார்	tamil
అలెగ్జాండర్	telugu
ਮੱਦਦ	punjabi
chalano	latin
নামটোৰ	ben_ass
कया	deva
பொருளாதாரக்	tamil
தேடுதல்	tamil
বাব	ben_ass
கட்டுரையை	tamil
વોલ	gujarati
Daisy	latin
ਕਟਾਈ	punjabi
രാജ്യത്തിന്	malayalam
అరెస్ట్	telugu
خلل	arabic
اداڪاره	arabic
விவசாயி	tamil
hottest	latin
ਤੇਜੀ	punjabi
ફેંગ	gujarati
మాస	telugu
ఉద్దేశం	telugu
లుక్	telugu
ಪತ್ರದಲ್ಲಿ	kannada
வேண்டுமென்றே	tamil
नीमको	deva
బాంబు	telugu
वस्त्रों	deva
നല്കിയത്	malayalam
ವ್ಯವಹಾರಗಳನ್ನು	kannada
ഹെക്റ്റർ	malayalam
नामकरणं	deva
মুন্সীগঞ্জ	ben_ass
shaan	latin
ਪੈਰਾ	punjabi
ગરબાડા	gujarati
अस्ट्रेलियन	deva
இடம்பெற்று	tamil
മില്ല്യൺ	malayalam
ਭਜਨ	punjabi
తాడిపత్రి	telugu
ندين	arabic
ਸਮਝਣਾ	punjabi
আবিষ্কারক	ben_ass
ചാക്യാർ	malayalam
রইল	ben_ass
જા	gujarati
ഇടങ്ങളിൽ	malayalam
staging	latin
bethan	latin
1980માં	gujarati
ക്വീൻ	malayalam
ہندِ	arabic
मन्दिरों	deva
প্রামাণ্যচিত্র	ben_ass
karwaane	latin
यशपाल	deva
মারমা	ben_ass
ಹಾಡಿದರು	kannada
নির্বাচক	ben_ass
ಮೂಡಿಸುವ	kannada
സിബിഐ	malayalam
ਮੰਜ਼ਿਲ	punjabi
വർഗ്ഗത്തിൽ	malayalam
अधिकारका	deva
స్థిరమైన	telugu
കൃത	malayalam
ಜೀಸಸ್	kannada
ਨਸ਼ੇ	punjabi
પદે	gujarati
ক্ৰান্তীয়	ben_ass
കല്യാണി	malayalam
chronology	latin
પ્રસંગો	gujarati
તંત્રી	gujarati
ఆంజనేయస్వామి	telugu
ಒಂದನೇ	kannada
પ્રવેશી	gujarati
ಹೊರೆ	kannada
জঙ্গিবাদ	ben_ass
লৌকিক	ben_ass
પસંદગીના	gujarati
immortal	latin
चित्रपटसृष्टीत	deva
મુક્યો	gujarati
அண்ணாதுரை	tamil
रज	deva
Waves	latin
പാമ്പുകൾ	malayalam
തോട്	malayalam
భూభాగాన్ని	telugu
ক্রোমোজোম	ben_ass
putu	latin
தீயில்	tamil
१६४	deva
ਕਾਵਿਕ	punjabi
താലൂക്കുകൾ	malayalam
కుమార	telugu
jag	latin
థాయ్	telugu
જ્ઞાતિ	gujarati
रक्षाबंधन	deva
സേതു	malayalam
Bit	latin
ಅತೀವ	kannada
jarimana	latin
ചിത്രമാണിത്	malayalam
રક્ષણાત્મક	gujarati
തുരങ്കം	malayalam
পরিকাঠামো	ben_ass
भवन्तः	deva
ڈیلی	arabic
தூரத்திலும்	tamil
ਤਰਕਸ਼ੀਲ	punjabi
ಬದಿಯ	kannada
ਗਿਆਨਪੀਠ	punjabi
ಮ್ಯಾಗಜೀನ್	kannada
प्राप्ती	deva
చేతికి	telugu
প্রদাহ	ben_ass
ಅಪೂರ್ಣ	kannada
ಸಂಕ್ರಾಂತಿ	kannada
ಗಮನಿಸಬಹುದು	kannada
शब्दांचा	deva
जेफ्री	deva
കാട്ടി	malayalam
اَدَب	arabic
તેંડુલકર	gujarati
ഡ്രൈവർ	malayalam
শিমুল	ben_ass
പ്രവർത്തക	malayalam
കുട്ടിക്കാലത്ത്	malayalam
ವರ್ಷಗಳನ್ನು	kannada
હોટ	gujarati
Gizbot	latin
کپاس	arabic
শীতে	ben_ass
अधिक्रुत्या	deva
బ్రాండ్	telugu
উগ্র	ben_ass
ગાડી	gujarati
أول	arabic
ഓപ്പറേറ്റിങ്ങ്	malayalam
അഭിനയിക്കുന്നത്	malayalam
نچلے	arabic
सोलंकी	deva
হানি	ben_ass
ക്വീൻസ്	malayalam
மாட்டார்	tamil
വീടുകളും	malayalam
Tal	latin
ક્વિબેક	gujarati
വഹിച്ചത്	malayalam
দলটোৱে	ben_ass
ছয়জন	ben_ass
ঘোষাল	ben_ass
ਮਾੜਾ	punjabi
Potential	latin
ಪ್ರಗತಿಯನ್ನು	kannada
కార్య	telugu
బంధువులు	telugu
కుటుంబకథా	telugu
ذاکر	arabic
পনেরো	ben_ass
صاحبان	arabic
விழாக்களில்	tamil
చెయ్యాలి	telugu
قاضيءَ	arabic
چاہ	arabic
પેકેટ	gujarati
ಕಾರ್ಯದರ್ಶಿಯಾಗಿ	kannada
সবকিছুই	ben_ass
ತೋರಿಸಿದರು	kannada
হিটলারের	ben_ass
രഞ്ജി	malayalam
ಏಜೆನ್ಸಿ	kannada
நாராயண்	tamil
ജീവശാസ്ത്രം	malayalam
ಕಲ್ಪನಾ	kannada
مالکان	arabic
छुह	deva
हर्फन	deva
ہُند	arabic
واہ	arabic
अशोके	deva
بوٚڑ	arabic
تَقويٖم	arabic
ثےشَُل	arabic
ساروٕے	arabic
مٔی	arabic
گٗروُ	arabic
ಮಿನಿಸ್ಟರ್	kannada
فنکاروں	arabic
നേര്	malayalam
இசைக்குழுவின்	tamil
ಎರಡರಲ್ಲೂ	kannada
ತಾಪಮಾನವು	kannada
বিশালাকার	ben_ass
കൺട്രോൾ	malayalam
ਪਠਾਰ	punjabi
ધોલેરા	gujarati
sabhyataa	latin
وہب	arabic
ਪੰਚ	punjabi
গোষ্ঠীৰ	ben_ass
ਰਨ	punjabi
ರೌಂಡ್	kannada
আটকা	ben_ass
தட்டச்சு	tamil
ರಹಮಾನ್	kannada
परियोजनाको	deva
കൽ	malayalam
دانشوروں	arabic
ಚೇತನ	kannada
সার্বিয়া	ben_ass
অন্তর্ভুক্তি	ben_ass
upwards	latin
ಬಹಿರಂಗವಾಗಿ	kannada
സിസ്റ്റർ	malayalam
ദര്	malayalam
ಸಾರ	kannada
پردو	arabic
ಭರತ	kannada
પરિષદના	gujarati
ਮੁਹਾਵਰੇ	punjabi
પૂજન	gujarati
মৌসুমি	ben_ass
થવો	gujarati
Theorem	latin
നിയോജക	malayalam
পোষা	ben_ass
സ്വരങ്ങൾ	malayalam
नुकतेच	deva
ಹಾನಿಕಾರಕ	kannada
വനത്തിൽ	malayalam
শিখে	ben_ass
அனுபவத்தை	tamil
पाण्डेको	deva
Rawalpindi	latin
parcel	latin
ज्यामितीय	deva
સ્વીકૃત	gujarati
ಸ್ಥಾನಮಾನವನ್ನು	kannada
مدفن	arabic
પ્રોટેસ્ટન્ટ	gujarati
காரி	tamil
विषया	deva
લુપ્ત	gujarati
കാലത്തിന്റെ	malayalam
کشمیریوں	arabic
നടക്കാൻ	malayalam
arivu	latin
1989માં	gujarati
வீரர்களும்	tamil
ઇતિહાસના	gujarati
സർക്യൂട്ട്	malayalam
જોખમમાં	gujarati
ಪಿಪ್	kannada
wellness	latin
పోలీసుల	telugu
பேங்க்	tamil
వాయువ్య	telugu
اسٽاف	arabic
ਖੁੱਲ੍ਹੀ	punjabi
سفرنامو	arabic
கருவியை	tamil
مجسمو	arabic
ರೊಡ್ಡಿಕ್	kannada
Canadians	latin
જેસર	gujarati
ചെലവു	malayalam
चिनिया	deva
anticipation	latin
ક્રિકેટમાં	gujarati
ವೀರೇಶ್ವರ	kannada
ಸೋತ	kannada
ಲೇಖನಗಳ	kannada
चढ़ने	deva
Naked	latin
അകമ്പടിയോടെ	malayalam
वासियों	deva
చిత్రంతో	telugu
रामायणातील	deva
நே	tamil
തങ്ങൾക്ക്	malayalam
आउ	deva
દ્રારા	gujarati
ಅಂತರದ	kannada
शीघ्रं	deva
ಗೋಪಾಲ	kannada
রাজকন্যা	ben_ass
સંગ્રામ	gujarati
బర్గ్	telugu
ਅਦਾਲਤਾਂ	punjabi
அற்புத	tamil
భగవద్గీత	telugu
રોકે	gujarati
क्रूज	deva
ਗਲਤੀ	punjabi
ميرس	arabic
కలవు	telugu
ಕೇರ್	kannada
व्यापारीक	deva
بلوچوں	arabic
ವಿಳಾಸ	kannada
فصلیں	arabic
ਮੁਰੰਮਤ	punjabi
చేసాయి	telugu
undani	latin
બનાવટ	gujarati
એસ્ટેટ	gujarati
వాయిదా	telugu
ஒலியின்	tamil
افادیت	arabic
ಸಾಮಾಜಿಕವಾಗಿ	kannada
धरली	deva
ڀاڱا	arabic
ఎల్లప్పుడూ	telugu
வெளிநாட்டில்	tamil
ఉపగ్రహాన్ని	telugu
ભૂલો	gujarati
لمحے	arabic
mutyamal	latin
പരിശീലനവും	malayalam
സമ്മാനങ്ങൾ	malayalam
கதாநாயகன்	tamil
پیا	arabic
UPTET	latin
جیٹ	arabic
સામાન્યતઃ	gujarati
હસ્તક	gujarati
डैनी	deva
ਬਖ਼ਸ਼	punjabi
நிறைவடைந்த	tamil
मतहरू	deva
ਸ਼੍ਰੇਣੀਬੱਧ	punjabi
வளிமம்	tamil
ہسپتالوں	arabic
১৮১৮	ben_ass
દર્શકો	gujarati
வரவேற்பை	tamil
ലിൻ	malayalam
ਨਾਨ	punjabi
Cannon	latin
നിരീക്ഷിച്ചു	malayalam
રોજર	gujarati
શ્રીલંકાની	gujarati
बिरामीलाई	deva
जुलाईमा	deva
Saw	latin
سمر	arabic
അവതരിപ്പിച്ച്	malayalam
ਖ਼ਬਰਾਂ	punjabi
సిక్కు	telugu
આવશ્યકતા	gujarati
گال	arabic
ബോബ്	malayalam
behaal	latin
ਕਭੀ	punjabi
ਖੜੇ	punjabi
ਦੀਵਾ	punjabi
Württemberg	latin
कॅन्सर	deva
bolte	latin
পৰিব	ben_ass
गंगाराम	deva
मृत्युदंड	deva
ਗੁਲਾਬੀ	punjabi
ಸುರಕ್ಷತಾ	kannada
পৰ্বতমালা	ben_ass
বাল্টিক	ben_ass
वायुयानानि	deva
बर्बर	deva
ದುಡಿದರು	kannada
गिरे	deva
ਅੱਜਕੱਲ੍ਹ	punjabi
വരുമാന	malayalam
ಪ್ರಚಾರಕ್ಕೆ	kannada
தாக்குதல்களை	tamil
ತರಗತಿಯ	kannada
ಹರಿಯಾಣ	kannada
ناظرین	arabic
கேட்டான்	tamil
ವೈಭವ	kannada
கல்லூரிக்கு	tamil
ਵਧਾਈ	punjabi
ਮਧੂ	punjabi
പൊക്കം	malayalam
நீயே	tamil
ਤੁਮ	punjabi
एकको	deva
એપલ	gujarati
తల్లిని	telugu
കുറഞ്ഞതും	malayalam
इंतज़ार	deva
ইমামের	ben_ass
२३५	deva
بڑھی	arabic
نمیبیا	arabic
అందాల	telugu
పుట్టుక	telugu
ಬಣ್ಣವು	kannada
ਲਗ	punjabi
ವ್ಯಾಪಾರಕ್ಕೆ	kannada
ప్రవేశించింది	telugu
சரித்திர	tamil
ہیڈکوارٹر	arabic
ਆਟਾ	punjabi
ಹಾವಿನ	kannada
പട്ടണത്തിന്	malayalam
ਬਾਡੀ	punjabi
ঘটনাই	ben_ass
مسلمین	arabic
comparisons	latin
સેનામાં	gujarati
ಕೂದಲನ್ನು	kannada
స్త్రీలకు	telugu
లూయిస్	telugu
ദീർഘമായ	malayalam
சாய்வு	tamil
താമരശ്ശേരി	malayalam
aayad	latin
1220	latin
સાંસદ	gujarati
Southeastern	latin
ینی	arabic
ನಿಲ್ಲುವ	kannada
ஆத்மா	tamil
دہانی	arabic
শ্যামাঙ্গিনী	ben_ass
محال	arabic
કંઇક	gujarati
1986માં	gujarati
आतंरिक	deva
ಆಚರಿಸುವ	kannada
രീതിയിലും	malayalam
తనికెళ్ళ	telugu
आंदोलने	deva
மனசு	tamil
ਗੇਂਦਾਂ	punjabi
ਮਾਰਕੀਟਿੰਗ	punjabi
എന്തുകൊണ്ട്	malayalam
மைக்ரோசாஃப்ட்	tamil
മണ്ണാർക്കാട്	malayalam
ഔഷധങ്ങൾ	malayalam
ವಾಸಿಸುತ್ತಾರೆ	kannada
ஊரான	tamil
ખુદ	gujarati
തിക്തം	malayalam
Nifty	latin
ਸ਼ਬਦ	punjabi
خزاں	arabic
ਉਪਗ੍ਰਹਿ	punjabi
ਡਾਕਘਰ	punjabi
விவசாயிகளின்	tamil
છોડો	gujarati
செயல்பாடுகளில்	tamil
ભેગી	gujarati
1866ء	arabic
Minh	latin
వాల్	telugu
ഗാന	malayalam
സാഹിത്യവും	malayalam
डाय	deva
എന്നിവർക്ക്	malayalam
1950ના	gujarati
সেও	ben_ass
অচেনা	ben_ass
ಮಾಡಿಸಿ	kannada
शेंगा	deva
Compact	latin
விஞ்ஞானம்	tamil
جاؤں	arabic
ਪੜਾਵਾਂ	punjabi
એટલેકે	gujarati
رباني	arabic
बिकट	deva
உதவிகளை	tamil
क्रिकेट्	deva
সংলাপের	ben_ass
apology	latin
pandey	latin
ઉત્પાદનની	gujarati
గ్రామంలో5	telugu
ڪڙي	arabic
సందర్భాల్లో	telugu
स्पैनिश	deva
Sudhir	latin
தளபதிகள்	tamil
ਦੇਰੀ	punjabi
બદામ	gujarati
ووٹوں	arabic
ટ્રાન્સપોર્ટ	gujarati
ಹೊಳಪು	kannada
swords	latin
নদীত	ben_ass
मच्छिन्द्रनाथको	deva
ਤੀਬਰਤਾ	punjabi
కోల్పోయిన	telugu
ஆர்சனிக்	tamil
വളരുകയും	malayalam
சொற்களும்	tamil
സ്വദേശം	malayalam
ശ്രീലങ്കയിലും	malayalam
پلس	arabic
গালি	ben_ass
૨૦૧૮	gujarati
প্ৰচণ্ড	ben_ass
جيڪر	arabic
ਬੈਟਰੀ	punjabi
૫૫	gujarati
സിസ്റ്റത്തിന്റെ	malayalam
ಸಿಡಿ	kannada
daleel	latin
ਉਕਤ	punjabi
ਖੇਡਦੀ	punjabi
సీతారామ	telugu
નોંધાયું	gujarati
शिवमंदिर	deva
పెద్దల	telugu
વસાહતો	gujarati
કુટુંબના	gujarati
വർഷത്തിനുള്ളിൽ	malayalam
تبصرے	arabic
ھدايت	arabic
தொலைதூர	tamil
വർദ്ധിപ്പിച്ചു	malayalam
புராணக்	tamil
गावस्कर	deva
வழங்குவதற்கு	tamil
পারদর্শীতা	ben_ass
మ్యాన్	telugu
akhiyawe	latin
மேட்டு	tamil
అంచనాలు	telugu
suvidhaayen	latin
پروا	arabic
प्रीती	deva
ਸਪਾਟਾ	punjabi
ਚਲਣ	punjabi
இவ்வட்டத்தின்	tamil
മുപ്പതു	malayalam
భాస్కర్	telugu
દેવનાગરી	gujarati
కృష్ణంరాజు	telugu
ਪੂੰਜੀਵਾਦੀ	punjabi
ছিনতাই	ben_ass
পিতাকে	ben_ass
ഫ്രീഡം	malayalam
ಸಚಿನ್	kannada
ശലഭം	malayalam
Kargil	latin
ਰਾਧਾ	punjabi
பார்வையை	tamil
পরিদর্শনে	ben_ass
ವೀಕ್ಷಣೆ	kannada
பைசா	tamil
টরন্টো	ben_ass
ಹಿ	kannada
ಬದಲಾವಣೆಗಳ	kannada
ಪದ್ಧತಿಯು	kannada
వేదికగా	telugu
বছরগুলিতে	ben_ass
আশায়	ben_ass
ಮೈಸೂರ್	kannada
அச்சுறுத்தல்	tamil
vega	latin
നിയന്ത്രിത	malayalam
മുളക്	malayalam
वकिली	deva
ਰੱਖੀਆਂ	punjabi
ഫ്രഞ്ചുകാർ	malayalam
நடத்தப்பட்டன	tamil
വിഭാഗങ്ങളായി	malayalam
થા	gujarati
ಕಾಮಿಕ್ಸ್	kannada
ನೀಡಿದವು	kannada
മാത്രവുമല്ല	malayalam
ధన	telugu
೦೧	kannada
نرگس	arabic
নেশা	ben_ass
ಅವರ್	kannada
അഹമ്മദാബാദ്	malayalam
പള്ളിപ്പുറം	malayalam
ಪ್ರೊಡಕ್ಷನ್ಸ್	kannada
हाउ	deva
দাঙ্গার	ben_ass
ടൌൺ	malayalam
ਅਰਥਸ਼ਾਸਤਰੀ	punjabi
નારિયેળ	gujarati
फुटबलर	deva
கவுன்டியில்	tamil
ਵਿਤਕਰੇ	punjabi
ത്രിമാന	malayalam
ભ્રષ્ટાચાર	gujarati
মৌলভী	ben_ass
ਰਚੀ	punjabi
શેષ	gujarati
ब्याटिङ	deva
ਅਣਗਿਣਤ	punjabi
धाकटा	deva
പാതയുടെ	malayalam
સમાવવામાં	gujarati
ಹರ್ಬರ್ಟ್	kannada
বিভ্রান্তি	ben_ass
बेलारूस	deva
இருந்தா	tamil
ഭാവന	malayalam
മദിരാശി	malayalam
মন্ত্রক	ben_ass
पाठविण्यात	deva
জেতে	ben_ass
Baxter	latin
જંકશન	gujarati
ಪ್ರೇಕ್ಷಕರನ್ನು	kannada
ਰੀਲੇਟੀਵਿਸਟਿਕ	punjabi
અમેરિકનો	gujarati
fig	latin
బౌలింగ్	telugu
ਫਰੈਂਕ	punjabi
ಆಧರಿತ	kannada
antagonist	latin
اینٹوں	arabic
पण्डितः	deva
വിന്	malayalam
పాలక	telugu
ಎಂಟನೆಯ	kannada
১২তম	ben_ass
ಒಪ್ಪಂದವು	kannada
१८४१	deva
ৰাজস্থান	ben_ass
ਵ੍ਹਾਈਟ	punjabi
ছায়া	ben_ass
શ્રમ	gujarati
வாய்வழி	tamil
مخلوقات	arabic
వేయడం	telugu
ബഹു	malayalam
স্বাভাবিকভাবে	ben_ass
উচ্চতাৰ	ben_ass
બિલબોર્ડ	gujarati
બનતું	gujarati
ਜੈਂਡਰ	punjabi
پریری	arabic
విదేశాలలో	telugu
ಮರೆತು	kannada
સંસ્કૃતિની	gujarati
یکسر	arabic
ਪੜ੍ਹੀ	punjabi
الموليٰ	arabic
எடிசன்	tamil
ഫൈസൽ	malayalam
সাসেক্স	ben_ass
சந்தைப்படுத்தல்	tamil
చిహ్నంగా	telugu
ఉంచారు	telugu
यथावत	deva
Prabhat	latin
कृष्णपक्षस्य	deva
உருமாற்றம்	tamil
ভগোৱা	ben_ass
सरयू	deva
નુક્શાન	gujarati
ललितपुरमा	deva
কাশ্মীরে	ben_ass
ചുരുക്കി	malayalam
பிறவி	tamil
রাষ্ট্রপ্রধান	ben_ass
বিরতির	ben_ass
Swallow	latin
ಅಡಿಪಾಯ	kannada
ਮਿਆਰ	punjabi
লোকসভালৈ	ben_ass
মঙ্গোলিয়া	ben_ass
Boulenger	latin
ಕಾಸ್ಮಿಕ್	kannada
furnished	latin
అదీ	telugu
అర్థ	telugu
ಉಪಗ್ರಹಗಳು	kannada
செயற்கையாக	tamil
പൗലോസിന്റെ	malayalam
രൂപത	malayalam
بازوں	arabic
ஏற்படவில்லை	tamil
मका	deva
செய்துவிட்டு	tamil
പഠനങ്ങളും	malayalam
naveenatam	latin
పవిత్రమైన	telugu
అక్కడకు	telugu
صوف	arabic
जुम्लाको	deva
ఎలాగైనా	telugu
ਪੁੱਜ	punjabi
ਸਪੀਰ	punjabi
कोइला	deva
দুইটা	ben_ass
વપરાશકર્તાઓ	gujarati
लेखनको	deva
رويو	arabic
ದಶಕಗಳಿಂದ	kannada
ಬಿಎಸ್	kannada
ઉત્	gujarati
ದೇಶದಿಂದ	kannada
लालसा	deva
ਮੁਸ਼ਕਲਾਂ	punjabi
సంస్కృతిని	telugu
ஊக்கம்	tamil
പാത്രങ്ങൾ	malayalam
ڏنڊ	arabic
ਟਰਾਂਸ	punjabi
अशांति	deva
સંસદમાં	gujarati
ನಿಕಟವಾಗಿ	kannada
ekda	latin
الائنس	arabic
பட்டப்படிப்பை	tamil
ಉದ್ದೇಶವಾಗಿತ್ತು	kannada
तिर्न	deva
ભીમ	gujarati
నెట్వర్క్	telugu
పుణ్య	telugu
ಪ್ರೊಸೆಸರ್	kannada
శ్రీవారి	telugu
লাকসাম	ben_ass
ஓபன்	tamil
క్రిస్టియన్	telugu
നാടകമാണ്	malayalam
ആയത്	malayalam
ਡਿਵੈਲਪਮੈਂਟ	punjabi
சொல்கிறேன்	tamil
epi	latin
പാവപ്പെട്ട	malayalam
மங்கோலியா	tamil
Benefit	latin
محلي	arabic
ആർട്ട്സ്	malayalam
ਸਵਾਰੀ	punjabi
મૂકવા	gujarati
थापालाई	deva
సాహిబ్	telugu
ಬೇಯಿಸಿ	kannada
پتي	arabic
heater	latin
ഒരിക്കല്	malayalam
اثبات	arabic
രൂപവത്കരിച്ചു	malayalam
വിളി	malayalam
പതിക്കുന്ന	malayalam
pakadaa	latin
సామెతలు	telugu
याउलट	deva
बेग	deva
હિમાલયન	gujarati
રોમાનિયા	gujarati
বিস্ময়	ben_ass
ਅਮੈਰੀਕਨ	punjabi
2008இல்	tamil
خلفائے	arabic
bikini	latin
ராமநாதன்	tamil
കാബൂൾ	malayalam
ఆకారం	telugu
కొండపై	telugu
माणसांच्या	deva
കൂത്ത്	malayalam
عادات	arabic
வீழ்ந்தது	tamil
পাতাল	ben_ass
ملایا	arabic
জোলি	ben_ass
সুদীর্ঘ	ben_ass
বিশ্বরেকর্ড	ben_ass
ಮಾಲೀಕ	kannada
తేజ	telugu
ஊராகும்	tamil
आर्चर	deva
పాల్గొంటారు	telugu
दार्जीलिङमा	deva
ರೇಖೆಯ	kannada
പെട്രോൾ	malayalam
বিহুত	ben_ass
ஸ்டெர்லைட்	tamil
ਬੋਲਦਾ	punjabi
రకంగా	telugu
Harlem	latin
ਪ੍ਰਿਅੰਕਾ	punjabi
બચવા	gujarati
ಎರಡನೆಯದಾಗಿ	kannada
ಬರುತ್ತಾನೆ	kannada
ઠીક	gujarati
ਮੁਕੱਦਮੇ	punjabi
খায়৷	ben_ass
திருத்த	tamil
மரத்தை	tamil
divisional	latin
फॉर्मेट	deva
കരുതിയ	malayalam
लैंडिंग	deva
कलेजको	deva
જિંદગી	gujarati
ಬೀರುತ್ತವೆ	kannada
گلو	arabic
হয়েছিলো	ben_ass
takalin	latin
কনফেডারেশন	ben_ass
ਸਮਰੂਪ	punjabi
রোগীকে	ben_ass
വാൾട്ട്	malayalam
yoth	latin
ਕੇਬਲ	punjabi
సూచిక	telugu
కాశ్మీరు	telugu
દેશોએ	gujarati
2016ൽ	malayalam
వ్యవహరించాడు	telugu
నర్సాపూర్	telugu
বুজাই	ben_ass
ಕೇಂದ್ರವಾಗಿತ್ತು	kannada
ബസാർ	malayalam
eagerly	latin
ਬਨਾਉਣ	punjabi
ജന്മി	malayalam
કથિત	gujarati
സേനാനിയും	malayalam
ਦਿਆਂ	punjabi
धीरूभाई	deva
అనంతపురంలోను	telugu
கட்சியாக	tamil
ಕೊಲೆಸ್ಟರಾಲ್	kannada
ವರದಿಗಳನ್ನು	kannada
ਕੇਂਦ੍ਰਿਤ	punjabi
ਬੇਰੀ	punjabi
ھيٺان	arabic
فے	arabic
ಮನು	kannada
ಸಾಮಗ್ರಿಗಳ	kannada
فلاسافر	arabic
synonymous	latin
টোল	ben_ass
मांजर	deva
സെൻസർ	malayalam
சாதிய	tamil
കണ്ടില്ല	malayalam
लेखनात	deva
ಕಾಲಾವಧಿ	kannada
একেকটি	ben_ass
ಕು	kannada
معاملو	arabic
মাজুলী	ben_ass
புஷ்	tamil
விராட்	tamil
বৰ্গৰ	ben_ass
تخیل	arabic
એકાદ	gujarati
उद्गार	deva
రవితేజ	telugu
قدموں	arabic
क्युरी	deva
அன்றாடம்	tamil
ಆರಕ್ಷಕ	kannada
നിയോജകമണ്ഡലത്തിൽ	malayalam
ಕುಸಿದು	kannada
ਖਾਦਾਂ	punjabi
ਸ਼ਾਹਮੁਖੀ	punjabi
സ്വീകാര്യത	malayalam
பேசும்போது	tamil
સુલતાન	gujarati
ഡ്രാഗൺ	malayalam
गोलले	deva
ਹਾਰਡੀ	punjabi
കെമിസ്ട്രി	malayalam
इन्द्राः	deva
মানচিত্ৰ	ben_ass
ಆರಾಧನಾ	kannada
మాల	telugu
ഉപദേശക	malayalam
गणपत	deva
എന്നോട്	malayalam
യൂസഫലി	malayalam
ദക്ഷിണേന്ത്യയിൽ	malayalam
বিবৃত	ben_ass
হায়াত	ben_ass
ಮಹರ್ಷಿ	kannada
রেস্তোরাঁ	ben_ass
ٹکڑا	arabic
கொள்ளவேண்டும்	tamil
ਸਵਾਗਤ	punjabi
పెరుగుతాయి	telugu
महाशिवरात्रि	deva
மாற்றமும்	tamil
ڪمائي	arabic
Aunt	latin
மரணத்தை	tamil
ਡੂੰਘਾਈ	punjabi
പ്രവർത്തനവും	malayalam
ಪ್ರಜೆಗಳ	kannada
ਤਰਫ	punjabi
ఉనికిని	telugu
ಗೋದಾವರಿ	kannada
कुराले	deva
லேசான	tamil
ക്രൂരമായി	malayalam
مرتکب	arabic
കഴിച്ചത്	malayalam
೨೦೦೬ರ	kannada
ಸತು	kannada
மாணவர்களுக்கான	tamil
ഏറ്റെടുത്ത്	malayalam
സ്ഥിരീകരിച്ചു	malayalam
સિક્યુરિટી	gujarati
ഗായികയും	malayalam
راقم	arabic
எப்படியாவது	tamil
कंकाल	deva
നദീ	malayalam
ਅਗਰਵਾਲ	punjabi
পাকিস্তানিরা	ben_ass
ರಾಷ್ಟ್ರಕೂಟರ	kannada
نازی	arabic
renew	latin
কৃষির	ben_ass
غرور	arabic
ਕਿੰਨੇ	punjabi
ਚਾਲੀ	punjabi
कुल्लू	deva
૧૪મી	gujarati
लघुरूप	deva
टीले	deva
દેવતાઓ	gujarati
خواں	arabic
conditioned	latin
hans	latin
நட்சத்திரமாக	tamil
ಅಥ್ಲೆಟಿಕ್	kannada
مستطيل	arabic
জমিদারের	ben_ass
Ghaziabad	latin
جملن	arabic
വയനാട്ടിലെ	malayalam
ब्राह्मणस्य	deva
ಇಸ್	kannada
ఆనందంగా	telugu
دیوناگری	arabic
മത്സരിച്ച്	malayalam
જલ્દી	gujarati
ಪರಿಣಮಿಸಿತು	kannada
પાત્રમાં	gujarati
പുസ്തകങ്ങളിൽ	malayalam
પેટ્રોલિયમ	gujarati
पोहोचतो	deva
गवई	deva
ਗਿਰਜਾ	punjabi
tolar	latin
فتوی	arabic
કિલ્લામાં	gujarati
Juice	latin
Functions	latin
ਪੌਲੀ	punjabi
રેસ	gujarati
ಕಲಿಕಾ	kannada
ആളെ	malayalam
கிராமப்	tamil
છાતી	gujarati
ਨਾਰੀਅਲ	punjabi
നക്ഷത്രരാശി	malayalam
گرنٿ	arabic
ہولی	arabic
ಅವಶ್ಯ	kannada
invaluable	latin
ਬਾਲਾ	punjabi
ਹਿੰਸਕ	punjabi
చేపట్టి	telugu
پراگ	arabic
busiest	latin
yaha	latin
વિજયી	gujarati
சோழர்களின்	tamil
പതിനായിരം	malayalam
praathamikta	latin
अखेरच्या	deva
తేది	telugu
പിതാവായി	malayalam
ലാസ്റ്റ്	malayalam
દુર્યોધન	gujarati
റൈസ്	malayalam
নৰেন্দ্ৰ	ben_ass
ಪಾತ್ರರಾಗಿದ್ದಾರೆ	kannada
चिंचोली	deva
રિંગ	gujarati
అప్పు	telugu
ఒకానొక	telugu
పొందుతారు	telugu
சுற்றுலாத்துறை	tamil
aforementioned	latin
ಸಂಘವು	kannada
ಔಷಧಗಳು	kannada
પાતળી	gujarati
કોનકોર્ડ	gujarati
ಶೇಕ್	kannada
দুবছৰ	ben_ass
अन्यैः	deva
ਲੋਕਲ	punjabi
யூரியா	tamil
مستقر	arabic
வார்த்தைகளைக்	tamil
ਭੇਜੀ	punjabi
بینر	arabic
સુધારવા	gujarati
టిడిపి	telugu
ಕಡು	kannada
الامام	arabic
கிராமத்து	tamil
જીડીપી	gujarati
পশ্চিমাঞ্চলীয়	ben_ass
ಲಿಟ್ಲ್	kannada
சேர்க்கப்படும்	tamil
dinajpur	latin
વહેવાર	gujarati
ధర్మము	telugu
സാഹിത്യത്തിലും	malayalam
ਵਿਸ਼ਵਵਿਆਪੀ	punjabi
সন্দেহভাজন	ben_ass
மதுரைக்	tamil
ഘടകങ്ങളും	malayalam
خوبيون	arabic
રાઇટ	gujarati
మాదిరిగానే	telugu
કિરણો	gujarati
ట్రంప్	telugu
barf	latin
শিখর	ben_ass
ડ્રાઇવ	gujarati
சக்தியின்	tamil
వైరల్	telugu
ದೈನಿಕ	kannada
ക്ലാസിക്	malayalam
niyantrane	latin
ജീവനക്കാരുടെ	malayalam
થયેલાં	gujarati
nutrient	latin
itampettres	latin
সোহরাওয়ার্দী	ben_ass
ഒറ്റയ്ക്ക്	malayalam
knocking	latin
വന്നിരുന്ന	malayalam
મુલાકાતમાં	gujarati
ਦਿੰਦਿਆਂ	punjabi
pratishthata	latin
೮೦೦	kannada
వాన్	telugu
নটৰাজ	ben_ass
অতিথিদের	ben_ass
ਸਿੱਕਾ	punjabi
ജഡ്ജി	malayalam
صدرالدين	arabic
రచనలను	telugu
ਪਾਤਸ਼ਾਹੀ	punjabi
సంస్థగా	telugu
ഗണിതശാസ്ത്ര	malayalam
अन्धविश्वास	deva
काव्यानि	deva
ലൂയിസിയാന	malayalam
نصيحت	arabic
ജയ്പൂർ	malayalam
ನೀಡಲಾಗುತ್ತಿದೆ	kannada
ब्राहमण	deva
உருவாயின	tamil
ખોટો	gujarati
अयोध्याकुलस्य	deva
വാച്ച്	malayalam
ਗੇਮਾਂ	punjabi
কচ্ছপ	ben_ass
unforgettable	latin
హైవే	telugu
ਪੜ੍ਹਦੇ	punjabi
சுந்தரி	tamil
પામ્યાં	gujarati
ફ્રાંસ	gujarati
mulkon	latin
Rubin	latin
குழுக்களில்	tamil
കവിതകളിൽ	malayalam
ধর্মতত্ত্ব	ben_ass
સેવાના	gujarati
வீழ்ந்து	tamil
ક્રોમ	gujarati
ವ್ಯವಹಾರಗಳಲ್ಲಿ	kannada
ਬਚਿਆ	punjabi
સૂચવ્યું	gujarati
ਫ਼ਿਰ	punjabi
પ્રીમિયર	gujarati
ഡാർക്ക്	malayalam
परिचायक	deva
വിരലുകൾ	malayalam
ಶಿವಾನಂದ	kannada
دانے	arabic
داوواغ	arabic
ಅದೃಷ್ಟ	kannada
കോവിലകം	malayalam
আকতার	ben_ass
চাইল্ড	ben_ass
نافرمانی	arabic
enge	latin
Relationships	latin
टोला	deva
संभाली	deva
நாயகனாக	tamil
ಬಫೆಟ್	kannada
கவனித்துக்	tamil
జంటగా	telugu
कुलभूषण	deva
పొందడానికి	telugu
Saying	latin
mughaumiyak	latin
ਸੂਬੇਦਾਰ	punjabi
সনাক্তকরণ	ben_ass
ਖੁੱਲ੍ਹ	punjabi
നിറഞ്ഞതാണ്	malayalam
ਸੈਮੀ	punjabi
ചാനലിൽ	malayalam
लण्डनमा	deva
തലവേദന	malayalam
পুষ্প	ben_ass
ఆపైన	telugu
ഉത്തരാഖണ്ഡ്	malayalam
மிகுந்து	tamil
आदानप्रदान	deva
വിദ്വാൻ	malayalam
ਨੂੰਹ	punjabi
ભગવદ્	gujarati
ಸಹಯೋಗದೊಂದಿಗೆ	kannada
தத்	tamil
હોદ્દો	gujarati
قيمتن	arabic
ਹਵਾਲੇ	punjabi
చూద్దాం	telugu
റീഡ്	malayalam
લોકલ	gujarati
ಕೈಗೊಂಡು	kannada
உள்ளதை	tamil
ਨੇਮ	punjabi
சேர்மங்களின்	tamil
कमेडी	deva
हरिकेन	deva
Tirunelveli	latin
ازمیر	arabic
ಚೆಸ್	kannada
జోగులాంబ	telugu
निकुञ्जमा	deva
కోరింది	telugu
प्वाल	deva
దినం	telugu
കാണുമ്പോൾ	malayalam
బిలియన్ల	telugu
जागरुकता	deva
saptahik	latin
கலர்	tamil
pakkane	latin
മദീനയിൽ	malayalam
Martínez	latin
ਹਿਸਾਰ	punjabi
అనువదించారు	telugu
ಮೇಲುಗೈ	kannada
ஆகியவையாகும்	tamil
વગરની	gujarati
રાષ્ટ્રપ્રમુખ	gujarati
ಅಲೆಗಳ	kannada
Terminalia	latin
جارجيا	arabic
ஏற்படுத்துகின்றன	tamil
கண்டறிந்தனர்	tamil
ಮುಖ್ಯಸ್ಥರಾಗಿ	kannada
துரியோதனன்	tamil
ചെമ്പൻ	malayalam
വികാരം	malayalam
പറക്കാൻ	malayalam
ত্রিভুজ	ben_ass
ಬಳಕೆಯಲ್ಲಿವೆ	kannada
தவறுதலாக	tamil
ഭാവം	malayalam
ਡਵੀਜ਼ਨ	punjabi
நம்மாழ்வார்	tamil
కాదా	telugu
ഉൾക്കടലിൽ	malayalam
araichi	latin
रोमेनिया	deva
बजरंगी	deva
سیکھ	arabic
യൂറോപ്പിന്റെ	malayalam
مالے	arabic
మెదక్లోనూ	telugu
గల్ఫ్	telugu
செனட்	tamil
બાબતોમાં	gujarati
ಸಂಸ್ಥಾನಗಳಲ್ಲಿ	kannada
مغفرت	arabic
upsthapan	latin
সেকেন্ডারি	ben_ass
McCartney	latin
ಭೂಗತ	kannada
தவறாகப்	tamil
ರೀತಿಗಳಲ್ಲಿ	kannada
ماریہ	arabic
मालिकेसाठी	deva
સોદો	gujarati
ਪ੍ਰਗਤੀ	punjabi
balan	latin
সেক্সি	ben_ass
కల్పన	telugu
हाताच्या	deva
مئگزين	arabic
गोधूमः	deva
Punk	latin
सर्वांचे	deva
اوطاق	arabic
locking	latin
కొండపల్లి	telugu
ইদ্রিস	ben_ass
முதுமை	tamil
அவருக்குக்	tamil
கோவாவின்	tamil
ಏಜ್	kannada
బై	telugu
വിക്ഷേപണ	malayalam
பிரித்தானியத்	tamil
abode	latin
ಅರಿಯಲು	kannada
સંભાળે	gujarati
পোশাকে	ben_ass
talaivars	latin
ਕਲਮੀ	punjabi
સંસ્કૃતિનું	gujarati
ঔদ্যোগিক	ben_ass
बोअर	deva
પુણેમાં	gujarati
जनमानस	deva
কমিশনে	ben_ass
দুডাল	ben_ass
ബിഹാരി	malayalam
വാങ്ങുകയും	malayalam
ਗ੍ਰੈਜੁਏਸ਼ਨ	punjabi
ಬಂದಂತೆ	kannada
માંડ્યો	gujarati
पुढची	deva
விட்டதால்	tamil
तैवान	deva
ভেন্যু	ben_ass
குளோப்	tamil
सज्ज	deva
മക്കളുണ്ട്	malayalam
இயக்குகிறது	tamil
সবাক	ben_ass
Radhika	latin
करणा	deva
جہالت	arabic
ഒരുക്കി	malayalam
ಗ್ರೇಟರ್	kannada
बालः	deva
एडगर	deva
മതിൽ	malayalam
बदलू	deva
తైవాన్	telugu
કોશિકા	gujarati
ಸಂಪ್ರದಾಯದಲ್ಲಿ	kannada
ಪ್ರೌಢಶಾಲಾ	kannada
നിർമ്മല	malayalam
salts	latin
प्रदोष	deva
స్కోరు	telugu
marana	latin
ದೇಶದಾದ್ಯಂತ	kannada
പുറത്തുവന്നു	malayalam
ਟੱਬਰ	punjabi
ಬೆಳೆಯನ್ನು	kannada
ક્રિયાઓ	gujarati
ഉമ്മ	malayalam
Melody	latin
نشاط	arabic
ಘಟನೆಯನ್ನು	kannada
ਕੱਢੇ	punjabi
ఎక్కడో	telugu
ಯೋಗಿ	kannada
વન્યજીવન	gujarati
ਬੈਕ	punjabi
والسلام	arabic
कैफीन	deva
ਤਾਂਕਿ	punjabi
તરફની	gujarati
paradox	latin
ખેડૂતોને	gujarati
ರೂಪಿಸಿ	kannada
sinchai	latin
jaggery	latin
મિર્ઝા	gujarati
ഉടമ്പടിയിൽ	malayalam
مسافت	arabic
શિક્ષણની	gujarati
ಸೌಕರ್ಯಗಳನ್ನು	kannada
زہد	arabic
ലോകാരോഗ്യ	malayalam
೧೭ನೇ	kannada
એપ્લીકેશન	gujarati
మొదలై	telugu
ਕੱਚੀ	punjabi
வேண்டினார்	tamil
வளர்கின்றன	tamil
روڪيو	arabic
গুঁড়ো	ben_ass
બોલર	gujarati
ಪ್ರಕಟಣೆಗಳು	kannada
मानवतावाद	deva
வெறி	tamil
வாணி	tamil
ఆహారంలో	telugu
அம்பிகை	tamil
മുങ്ങി	malayalam
مسافرن	arabic
مہاتما	arabic
ಎಂಬುವರು	kannada
बोलल्या	deva
মহল্লা	ben_ass
پڌري	arabic
ਦਸ਼ਾ	punjabi
અસરને	gujarati
ಚಿಕಿತ್ಸೆಗಾಗಿ	kannada
તાકાત	gujarati
ਟੇਲਰ	punjabi
সিকান্দার	ben_ass
നടത്താം	malayalam
അവിഭക്ത	malayalam
ഓർക്കിഡ്	malayalam
ജോർജിയ	malayalam
জর্জিয়ার	ben_ass
bisexual	latin
ખુલાસો	gujarati
ഇറാനിൽ	malayalam
ਸਮਿੱਟਰੀ	punjabi
হয়ঃ	ben_ass
থিওরি	ben_ass
சுழற்சியில்	tamil
बैङ्क्	deva
বহা	ben_ass
પ્રક્રિયાની	gujarati
ಸಂಕಲ್ಪ	kannada
வசித்த	tamil
સ્નાતકની	gujarati
overlooked	latin
ਹਾਈਡਰੋਜਨ	punjabi
టీం	telugu
ತುಂಬಲು	kannada
শ্ৰদ্ধা	ben_ass
रणनीतियों	deva
زخمیوں	arabic
ವಜ್ರ	kannada
herein	latin
துத்தநாகம்	tamil
மண்டை	tamil
প্রেসক্লাব	ben_ass
પાઠક	gujarati
ভালেসংখ্যক	ben_ass
ചെറിയാൻ	malayalam
0050d0	latin
देशस्	deva
ನೊವಾಕ್	kannada
چھاپ	arabic
കൂടും	malayalam
রিমান্ড	ben_ass
ಲೂಯಿಸಿಯಾನ	kannada
ಕರೆದಿದ್ದಾರೆ	kannada
ಕಾರ್ಪಸ್	kannada
രാഷ്ട്രീയകക്ഷികൾ	malayalam
ಯತ್ನ	kannada
ஆகாது	tamil
ઓળખે	gujarati
आजूबाजूला	deva
നേർച്ച	malayalam
perfume	latin
കഴുത്തും	malayalam
കാബൂളിൽ	malayalam
অনুভূমিক	ben_ass
ಗುಡ್ಡದ	kannada
ಹತ್ತೊಂಬತ್ತನೆಯ	kannada
ಒಳಪಟ್ಟ	kannada
ರೂಪಿಸುತ್ತದೆ	kannada
ਧਨੀ	punjabi
రామచంద్రాపురం	telugu
પત્થર	gujarati
ಕಿತ್ತು	kannada
ಚಪ್ಪಟೆ	kannada
खनिजे	deva
ಆಡಲಾಗುತ್ತದೆ	kannada
1947లో	telugu
अधिराज्यमा	deva
फेकून	deva
सातवटा	deva
দক্ষিণাংশে	ben_ass
ద్రవం	telugu
സമുദ്രത്തിന്റെ	malayalam
विशिष्टः	deva
മലമ്പുഴ	malayalam
சில்வர்	tamil
ಒಲಂಪಿಕ್ಸ್	kannada
યુરોપની	gujarati
karmchari	latin
மலைக்கு	tamil
ప్రచురణలు	telugu
stains	latin
সৈন্যই	ben_ass
ಚಿಕ್ಕಪ್ಪ	kannada
মালায়ালম	ben_ass
உதவிய	tamil
सोनीपत	deva
ಬಿದ್ದಾಗ	kannada
రాజకీయంగా	telugu
ತಿಳಿಸುತ್ತವೆ	kannada
सिरिज	deva
महलों	deva
ಚೋಪ್ರಾ	kannada
മാറിയിരിക്കുന്നു	malayalam
மற்றவர்களுக்கு	tamil
ಟಾಗೋರ್	kannada
আউটের	ben_ass
ਅੰਗਰੇਜਾਂ	punjabi
ಗಮನಿಸಬೇಕಾದ	kannada
మొట్టమొదట	telugu
கலந்துகொண்டார்	tamil
ٿئيس	arabic
పరిస్థితుల	telugu
0183	latin
মুহূর্তের	ben_ass
నిన్న	telugu
ஈழம்	tamil
ليڪچر	arabic
ಶಸ್ತ್ರಾಸ್ತ್ರಗಳ	kannada
ഞായർ	malayalam
ಸೂಚಿಸಿದೆ	kannada
অম্বিকা	ben_ass
ਵਿਜੈ	punjabi
பெறுவர்	tamil
Athirady	latin
Presented	latin
அழகர்	tamil
ਸ੍ਰ	punjabi
આભારી	gujarati
ತಿಳಿಸಲು	kannada
ராஜு	tamil
रुपयों	deva
निचला	deva
ವಿಜಯಾ	kannada
બાદની	gujarati
बांधकर	deva
સાર્વત્રિક	gujarati
ওয়াল্ট	ben_ass
भाँडो	deva
শোতে	ben_ass
ರಿವ್ಯೂ	kannada
عروہ	arabic
ಈಸ್ಟರ್	kannada
യഹോവ	malayalam
ਗਾਉਣਾ	punjabi
വിവരണങ്ങൾ	malayalam
Reno	latin
مشیل	arabic
നശിപ്പിക്കുകയും	malayalam
অধিবেশনৰ	ben_ass
বাজ	ben_ass
અરબ	gujarati
ਵੇਚਿਆ	punjabi
செய்யுமாறு	tamil
ತತ್ವಶಾಸ್ತ್ರದ	kannada
नेहमीच्या	deva
గోపీచంద్	telugu
പതനം	malayalam
ఊపిరి	telugu
লাওসের	ben_ass
நிலையிலுள்ள	tamil
കാർട്ടർ	malayalam
বিন্যাসের	ben_ass
தொடு	tamil
పద్ధతులను	telugu
الشریعہ	arabic
परेरा	deva
নিয়ন্ত্ৰণৰ	ben_ass
અવર	gujarati
কেনো	ben_ass
pumped	latin
അണിയറപ്രവർത്തകർ	malayalam
ऍन	deva
بناوٹ	arabic
வலைப்பின்னல்	tamil
विद्रोहको	deva
Mycobacterium	latin
આસપાસનાં	gujarati
2020ء	arabic
कक्षमा	deva
এমিল	ben_ass
കണ്ടെത്തലുകൾ	malayalam
বক্সার	ben_ass
മാധ്യമങ്ങളിൽ	malayalam
પૌલ	gujarati
ਇਨਸਾਨਾਂ	punjabi
মানক	ben_ass
गाएको	deva
ત્યા	gujarati
શોધક	gujarati
ಉಪಗ್ರಹಗಳನ್ನು	kannada
نانڪ	arabic
ಸ್ಮೃತಿ	kannada
রোশন	ben_ass
നിർമ്മിക്കാനുള്ള	malayalam
ఆకులను	telugu
కెనడాలో	telugu
oversight	latin
ఒడిశా	telugu
મુકેશ	gujarati
کیمبل	arabic
ಇಂದೂ	kannada
drastically	latin
عیش	arabic
ਤਰਨ	punjabi
vidyuttu	latin
ನಲ್ಲಿಯೂ	kannada
مناجات	arabic
ناريل	arabic
ಲೈಕ್	kannada
અન્ના	gujarati
మణుగూరు	telugu
అమ్మాయిని	telugu
சாரணர்	tamil
নিজাকৈ	ben_ass
സ്പിൻ	malayalam
૨૦૦૯માં	gujarati
हस्तशिल्प	deva
అనుకూల	telugu
باون	arabic
ਹਮਾਇਤ	punjabi
ఒక్కోసారి	telugu
ભરવા	gujarati
వార	telugu
ਦੰਡੀ	punjabi
ಸಂಭವ	kannada
سيٽلائيٽ	arabic
ਯੂਟਿਊਬ	punjabi
ਹਾਰਡ	punjabi
గోపాలకృష్ణ	telugu
दृश्यता	deva
করিমগঞ্জ	ben_ass
ప్రమాదాలు	telugu
spardhaa	latin
திறனைக்	tamil
અરકાનસાસ	gujarati
ಸೂಕ್ಷ್ಮವಾದ	kannada
ಪೆರಾಕ್ಸೈಡ್	kannada
اللہﷺ	arabic
ఘన్	telugu
రాజైన	telugu
ಔಷಧಿಗಳು	kannada
મુલાકાતે	gujarati
کیلے	arabic
నగరాల్లో	telugu
کنواں	arabic
महाग	deva
সময়কে	ben_ass
ghatnasthle	latin
ਬਾਬਤ	punjabi
ಅರ್ಹ	kannada
பயிற்சியாளராக	tamil
قاضن	arabic
ಚಿಲಿ	kannada
ਅੰਡੇਮਾਨ	punjabi
കോപ്റ്റിക്	malayalam
અનુવાદો	gujarati
ਗਣੇਸ਼	punjabi
जिन्दा	deva
குங்குமம்	tamil
పొన్నూరు	telugu
زہرا	arabic
૬૦૦	gujarati
ਰੂਪਾਂਤਰਨ	punjabi
સેટેલાઇટ	gujarati
Henrik	latin
నదిపై	telugu
পুরী	ben_ass
ਪੈਨਲ	punjabi
సతీష్	telugu
ક્રમચય	gujarati
१८१२	deva
ਚਮਕੌਰ	punjabi
Dom	latin
માનવા	gujarati
ਪਉੜੀ	punjabi
ഉൽപ്പാദനം	malayalam
ਸਮਰਪਤ	punjabi
ਅਬਦਾਲੀ	punjabi
ఆంధ్రుల	telugu
Deposit	latin
કાચ	gujarati
அருவிகள்	tamil
ಹೋಲ್	kannada
ਵਡੇਰੇ	punjabi
राष्ट्रले	deva
ময়দানে	ben_ass
இருவேறு	tamil
ನೊಂದಿಗಿನ	kannada
ഇൻഡീസ്	malayalam
ਪ੍ਰੀਤੀ	punjabi
ਹਿਮਾਲਾ	punjabi
مستحڪم	arabic
చదవడం	telugu
ਸ਼ੋਭਾ	punjabi
చట్టాన్ని	telugu
നൽകുവാൻ	malayalam
കാർലോസ്	malayalam
Packard	latin
তদুপরি	ben_ass
ಸರಿಸುಮಾರಾಗಿ	kannada
മൂല	malayalam
विद्युतचुंबकीय	deva
فہد	arabic
പെട്ടെന്നുള്ള	malayalam
நன்னிலம்	tamil
తయారైన	telugu
रेने	deva
ਪਛਾਣੇ	punjabi
உடலுறவு	tamil
అన్నవరం	telugu
స్ట్రీట్	telugu
ಆಯುಧಗಳು	kannada
উদ্ভিদজগত	ben_ass
૨૫૦	gujarati
Somewhere	latin
ఇపుడు	telugu
डॉलर्स	deva
বুজাব	ben_ass
વુડ્સે	gujarati
চৌ	ben_ass
હિમાલયની	gujarati
ರೊಮ್ಯಾಂಟಿಕ್	kannada
കൂടുന്നു	malayalam
পদ্ধতিকে	ben_ass
पठाइएको	deva
ਕਠਿਨ	punjabi
ఇటీవలే	telugu
Bourbon	latin
లోతు	telugu
గెలుపొందాడు	telugu
pushavar	latin
رسمي	arabic
ഫെമിനിസ്റ്റ്	malayalam
சென்றன	tamil
অটুট	ben_ass
இக்குழு	tamil
চট্টোপাধ্যায়ের	ben_ass
ਸਹੁਰੇ	punjabi
మెల్లగా	telugu
శిలా	telugu
మండలాలతో	telugu
ചിത്രമായി	malayalam
ಅಲ್ಪಾವಧಿ	kannada
૩૭	gujarati
ruuh	latin
அனுப்பப்பட்டார்	tamil
Lundell	latin
પક્ષમાં	gujarati
ಇಂಗ್ಲೆಂಡಿಗೆ	kannada
ચુકવણી	gujarati
இதிலுள்ள	tamil
ದಕ್ಷತೆ	kannada
மாநாட்டின்	tamil
যেটিতে	ben_ass
ਸੱਤਵੀਂ	punjabi
വരവോടെ	malayalam
Luftwaffe	latin
દરિયામાં	gujarati
ਜ਼	punjabi
ਫਾਸਟ	punjabi
સહાયતા	gujarati
ఈమెను	telugu
ಕಂಪನಿಯಲ್ಲಿ	kannada
Bloomington	latin
திட்டமாகும்	tamil
जंगी	deva
யுடன்	tamil
زينب	arabic
هالائي	arabic
సిద్ధాంత	telugu
దాసు	telugu
নেশনস	ben_ass
অপহৃত	ben_ass
அறிவார்ந்த	tamil
வைப்புத்	tamil
పీటర్	telugu
వరుణ్	telugu
సామర్ధ్యం	telugu
చిహ్నాలు	telugu
ശം	malayalam
கடற்படையின்	tamil
പദ്ധതികളും	malayalam
نغمات	arabic
ઓગષ્ટ	gujarati
ਵਟਾਂਦਰਾ	punjabi
ಗ್ರಾಮಗಳಲ್ಲಿ	kannada
ഹെയ്	malayalam
কামৰূপী	ben_ass
శుభ్రం	telugu
বৰদলৈয়ে	ben_ass
ശ്വാസകോശ	malayalam
லஞ்சம்	tamil
ফাঁদ	ben_ass
Bamboo	latin
ഇൻഡ്യ	malayalam
ਤਾਰਨ	punjabi
பொதுச்செயலாளர்	tamil
१६२७	deva
कार्यस्य	deva
டயர்	tamil
ಕಂಬದ	kannada
اطہر	arabic
ખર્ચમાં	gujarati
Benton	latin
ਗੋਰਖ	punjabi
சொற்பொழிவு	tamil
واٹسن	arabic
চলচ্চিত্ৰখনে	ben_ass
స్వతంత్రంగా	telugu
எழுந்தன	tamil
પીણું	gujarati
পোস্টের	ben_ass
கல்லூரிப்	tamil
வெங்கடேஷ்	tamil
యాదవ	telugu
સાચવી	gujarati
पुस्तकालयों	deva
હાનિ	gujarati
Infectious	latin
ચાની	gujarati
இறக்கை	tamil
ప్రాణ	telugu
ಕಟ್ಟಿಕೊಂಡು	kannada
ਮਨੀਪੁਰ	punjabi
गायी	deva
സഹോദരിയും	malayalam
ವರ್ಣಿಸಲಾಗಿದೆ	kannada
ভুগছিলেন	ben_ass
ايما	arabic
നിരോധന	malayalam
രാജഗോപാൽ	malayalam
వెళితే	telugu
دهشتگردي	arabic
baths	latin
ধনৰ	ben_ass
footprint	latin
ದಲ್ಲಿನ	kannada
ફૂટબૉલ	gujarati
ಪಟ್ಟಣಕ್ಕೆ	kannada
૬૫	gujarati
oversaw	latin
তুচ্ছ	ben_ass
పశ్చిమగోదావరి	telugu
పోషించిన	telugu
రఘుబాబు	telugu
गाडगेबाबा	deva
അംഗമായവർ	malayalam
சுரங்கத்	tamil
ਖਲਨਾਇਕ	punjabi
ਚੀਮਾ	punjabi
रावबहादुर	deva
સાંજ	gujarati
dastavej	latin
ਚਾਰਟ	punjabi
ਦਲਿਤਾਂ	punjabi
بائیکاٹ	arabic
ಭಗತ್	kannada
എരുമേലി	malayalam
اوستا	arabic
விடுவிக்க	tamil
પ્રેમી	gujarati
ಹಸು	kannada
proceeding	latin
કૃષ્ણના	gujarati
அளவுகளை	tamil
బ్యాటరీ	telugu
तेवढे	deva
ಬಿರುಗಾಳಿ	kannada
vibhaajan	latin
ব্যারি	ben_ass
puropuri	latin
அனுராதபுரம்	tamil
পৰ্বতীয়া	ben_ass
ಹಿಂಸಾತ್ಮಕ	kannada
সহকর্মীদের	ben_ass
షాహ్	telugu
ڇپرايو	arabic
ಹೆಚ್ಚಿಸುವುದು	kannada
വേറിട്ട	malayalam
কেইবাবাৰো	ben_ass
કોલંબો	gujarati
liquids	latin
பிட்காயின்	tamil
தடைகளை	tamil
వేడుక	telugu
தொழில்நுட்பத்	tamil
ವಿವರಣೆಗಳು	kannada
నృత్యాలు	telugu
اٽو	arabic
बंदरगाहों	deva
ਉਦਯੋਗਾਂ	punjabi
सायन	deva
ദ്വീപും	malayalam
આકારમાં	gujarati
ಪ್ರತಿಯೊಂದೂ	kannada
چيلهه	arabic
ਨਾਸਾ	punjabi
పేరొందిన	telugu
మరింతగా	telugu
೬೨	kannada
ছেপ্তেম্বৰত	ben_ass
ಸರ್ವ್	kannada
પાતળા	gujarati
ભવિષ્યની	gujarati
భావ	telugu
ಗಾಯಗೊಂಡ	kannada
ಫಿಲಂ	kannada
பொருளாதாரத்	tamil
కారణమని	telugu
నాణ్యమైన	telugu
గాయత్రి	telugu
رض	arabic
চরফ্যাশন	ben_ass
ڏوڪري	arabic
ਗੱਠਜੋੜ	punjabi
প্ৰথমাৱস্থাত	ben_ass
মাহলৈ	ben_ass
ربی	arabic
போதெல்லாம்	tamil
வர்த்தகப்	tamil
বিপর্যয়ের	ben_ass
నాతో	telugu
क्रिस्	deva
ಹೂಗಳನ್ನು	kannada
കൊട്ടാരത്തിന്റെ	malayalam
નગરના	gujarati
ಶಿಲೆಯ	kannada
অতিকৈ	ben_ass
೫೮	kannada
ಶಿಕ್ಷೆಯನ್ನು	kannada
রেবেকা	ben_ass
ஒருபுறம்	tamil
ಮುರಿದ	kannada
కాథలిక్	telugu
इस्रो	deva
ਕਾਜ	punjabi
ಜೋಡಿಯು	kannada
ಕೀಟಗಳನ್ನು	kannada
1985ರಲ್ಲಿ	kannada
ആവിഷ്കാര	malayalam
सैकड़ों	deva
taral	latin
సారవంతమైన	telugu
மாதங்களுக்குப்	tamil
ట్	telugu
గవర్నమెంట్	telugu
వివాహాలు	telugu
فونٹ	arabic
اکمل	arabic
هالن	arabic
பெய்து	tamil
ബൈക്ക്	malayalam
SO4	latin
সামাজিকভাবে	ben_ass
மாநிலங்களிலும்	tamil
கம்பளி	tamil
অযৌক্তিক	ben_ass
ਆਈਆਈਟੀ	punjabi
ಕಣದ	kannada
اسیر	arabic
ന്യൂട്ടൺ	malayalam
ಕಲರ್	kannada
ਪਲੇ	punjabi
ലിബറൽ	malayalam
মালি	ben_ass
ax	latin
ভাঙ্গন	ben_ass
బోధన	telugu
आर्यभट्ट	deva
ઈટાલિયન	gujarati
१७७८	deva
ಕೋಣೆಯಲ್ಲಿ	kannada
೧೯೩೫	kannada
ಗಡಿಯಲ್ಲಿ	kannada
జార్జియా	telugu
અદા	gujarati
ખેલાડીઓને	gujarati
ಫೆ	kannada
గ్రామంలో6	telugu
ಸಣ್ಣದಾದ	kannada
ಹೊಟೆಲ್	kannada
نيپچون	arabic
આવ્	gujarati
سیکڑوں	arabic
ತಿಳಿಸಿತು	kannada
पंडितों	deva
இழுத்துச்	tamil
موریشس	arabic
બોલને	gujarati
Fairfield	latin
அர்ஜென்டினா	tamil
വിചിത്രമായ	malayalam
ਤਿੰਨੇ	punjabi
വിടുകയും	malayalam
প্রস্তাবটি	ben_ass
ਪਾਬੰਦੀਆਂ	punjabi
ಇವೆಲ್ಲಾ	kannada
கொரியாவின்	tamil
রক্ষণভাগের	ben_ass
ਮੋਟੀ	punjabi
ప్రత్యక్షంగా	telugu
Guys	latin
పూరి	telugu
அசையும்	tamil
vivyis	latin
1987ರಲ್ಲಿ	kannada
پہچانے	arabic
વ્યવહારુ	gujarati
ਨਿਕਲਦੇ	punjabi
jaadu	latin
بالادستی	arabic
हड़ताल	deva
Bicycle	latin
محرک	arabic
भुजबळ	deva
కథకు	telugu
ਫੈਕਟਰ	punjabi
પોલો	gujarati
പൊട്ടി	malayalam
ഉപരിപഠനം	malayalam
సీరీస్	telugu
Cooke	latin
2009இல்	tamil
شارع	arabic
ಸಾಸ್	kannada
ਤਿੱਖੀ	punjabi
સાથીઓ	gujarati
பழனிச்சாமி	tamil
ಸರಿಯಲ್ಲ	kannada
पत्नियों	deva
ਨਿੰਦਾ	punjabi
صوبیدار	arabic
لاشیں	arabic
आत्माको	deva
কেশৱ	ben_ass
فضيلت	arabic
టెక్	telugu
இயங்குதளம்	tamil
సీమ	telugu
ઉઠાવી	gujarati
ماریا	arabic
തെളിഞ്ഞ	malayalam
সিংয়ের	ben_ass
ಅಪಾಚೆ	kannada
സ്വതേ	malayalam
Qadir	latin
কোঠা	ben_ass
14న	telugu
7ஆம்	tamil
অনুপস্থিতি	ben_ass
ಛಾಯಾಚಿತ್ರಗಳನ್ನು	kannada
পকী	ben_ass
কৰণ	ben_ass
വിളവെടുപ്പ്	malayalam
தேசங்கள்	tamil
வெளிப்படுகிறது	tamil
విషయాల	telugu
ਐਲੀਮੈਂਟਰੀ	punjabi
చేసుకోవాలని	telugu
Shelby	latin
પૂંછડી	gujarati
മഹത്ത്വം	malayalam
ಪ್ರಯಾಣಿಕರಿಗೆ	kannada
നാവികസേന	malayalam
মুজিবের	ben_ass
আহিলা	ben_ass
அளவீட்டு	tamil
ആശയങ്ങളെ	malayalam
సినిమాని	telugu
કૌશલ્ય	gujarati
ਏਂਗਲਜ਼	punjabi
ঢেকিয়াল	ben_ass
ಲೋಕಕ್ಕೆ	kannada
પામતા	gujarati
വിളിക്കാം	malayalam
कोथिंबीर	deva
शेठ	deva
ਸੱਤਵੇਂ	punjabi
அமெரிக்காவை	tamil
നിർത്താൻ	malayalam
ਸਲਾਦ	punjabi
معلیٰ	arabic
కట్టడాలు	telugu
ਕਲੱਬਾਂ	punjabi
magavari	latin
പ്രതിഷ്ഠിച്ചു	malayalam
hooked	latin
બંનેએ	gujarati
ವಂಡರ್	kannada
હેલ	gujarati
கரிய	tamil
చిన్నారి	telugu
ওয়াহিদ	ben_ass
ಶೋಧಕ	kannada
